MSOA Code,pop0-49,pop50-59,pop60-69,pop70-79,pop80-89,pop90+,total_pop
E02002483,6549,1378,1025,825,436,48,10261
E02002484,6461,1465,1209,811,396,107,10449
E02002485,5189,1123,828,697,319,29,8185
E02002487,3583,725,507,295,150,17,5277
E02002488,3182,959,818,551,278,60,5848
E02002489,4938,990,849,523,342,88,7730
E02002490,3921,945,728,414,180,26,6214
E02002491,3842,898,724,530,388,72,6454
E02002492,3960,997,860,608,377,85,6887
E02002493,3544,1031,952,723,381,71,6702
E02002494,5037,1024,815,500,288,86,7750
E02006909,5725,2065,1786,1543,646,141,11906
E02002496,11124,855,699,359,185,30,13252
E02002497,4104,728,588,351,157,16,5944
E02002498,7754,827,578,343,135,27,9664
E02002499,5084,898,743,382,241,58,7406
E02002500,4057,711,602,346,163,40,5919
E02002501,3725,777,560,328,144,28,5562
E02002502,5748,1345,1087,655,335,51,9221
E02002503,4677,824,653,350,195,34,6733
E02002504,6602,1267,935,627,303,54,9788
E02002505,4208,763,620,293,188,32,6104
E02002506,3818,727,493,385,235,28,5686
E02002507,3579,885,600,601,288,39,5992
E02002508,2757,693,646,547,367,57,5067
E02002509,3217,753,719,378,290,38,5395
E02002510,3090,777,847,820,335,59,5928
E02002512,2697,866,704,648,336,47,5298
E02002513,5506,1158,1248,834,423,92,9261
E02002514,4727,1406,1139,745,426,85,8528
E02006811,5613,1429,1299,1194,587,110,10232
E02002515,4184,1051,730,530,308,100,6903
E02002516,3528,860,650,503,263,49,5853
E02002517,3179,787,585,485,272,36,5344
E02002518,5908,1811,1439,1065,511,103,10837
E02002519,4264,941,937,810,420,83,7455
E02002520,6629,1958,1694,1744,821,100,12946
E02002521,2880,961,867,843,433,128,6112
E02002523,4877,724,560,323,117,22,6623
E02002524,3144,775,674,649,223,41,5506
E02002525,4374,1329,1119,854,454,82,8212
E02002526,4499,1143,1043,743,258,49,7735
E02002527,3094,709,573,484,159,59,5078
E02002529,3241,953,777,617,249,42,5879
E02002530,3285,992,866,816,338,35,6332
E02002532,3783,970,810,655,342,95,6655
E02002533,3266,876,922,742,362,71,6239
E02002534,2547,824,863,967,407,85,5693
E02006812,4124,1096,990,824,444,70,7548
E02006910,5964,1549,1211,929,476,71,10200
E02002535,4959,1636,1385,870,416,70,9336
E02002536,5688,1416,1132,891,540,104,9771
E02002537,5578,1251,836,545,386,45,8641
E02002538,3469,814,697,523,236,41,5780
E02002539,4875,1639,1338,1070,436,56,9414
E02002540,2890,856,948,845,425,71,6035
E02002541,3569,909,753,573,298,44,6146
E02002542,5382,1131,845,561,262,61,8242
E02002543,6179,1186,845,498,304,53,9065
E02002544,5863,1113,843,539,296,40,8694
E02002545,2602,772,788,660,318,51,5191
E02002546,4981,1058,713,454,244,53,7503
E02002547,2932,951,928,855,449,78,6193
E02002548,10222,1591,1074,615,269,72,13843
E02002549,3595,1092,1043,1036,526,104,7396
E02002550,3493,989,740,570,320,72,6184
E02002551,5352,695,541,318,185,62,7153
E02002552,4777,931,814,457,219,48,7246
E02002553,3668,726,677,527,303,48,5949
E02002554,3062,693,674,550,266,35,5280
E02002555,5808,1404,1245,1054,519,101,10131
E02002556,3963,1181,1047,580,184,24,6979
E02002557,12223,2348,1056,520,176,62,16385
E02002558,5907,1536,1530,1169,553,96,10791
E02002559,5263,1440,1155,928,324,47,9157
E02002560,3650,927,669,565,248,28,6087
E02002561,2693,827,893,597,250,45,5305
E02002562,3506,906,633,476,268,51,5840
E02002563,2834,765,799,573,362,113,5446
E02002564,5986,1396,1023,827,420,77,9729
E02002565,3183,740,581,366,181,23,5074
E02002566,4805,931,572,392,208,34,6942
E02002567,5690,1031,881,712,358,53,8725
E02002568,3130,958,764,650,387,111,6000
E02002569,3994,1356,1298,1295,868,203,9014
E02002570,4830,1004,864,617,353,103,7771
E02002571,4246,858,614,480,269,40,6507
E02002572,4348,882,577,421,165,20,6413
E02002573,4777,1308,1142,1012,438,116,8793
E02002574,5182,1269,925,845,370,50,8641
E02002575,5796,1616,1272,736,289,43,9752
E02002576,4266,1021,964,666,362,62,7341
E02002577,4834,971,841,594,316,75,7631
E02002578,5179,1243,959,623,358,39,8401
E02002579,5005,1130,873,598,287,45,7938
E02002580,5561,1006,760,448,232,39,8046
E02002581,4017,1021,1026,828,375,55,7322
E02002582,5190,1559,1126,621,232,58,8786
E02002583,5005,886,846,645,184,33,7599
E02002584,4530,1018,832,633,322,68,7403
E02002585,6747,1468,1162,788,349,66,10580
E02002586,6672,1267,965,758,315,49,10026
E02002587,4169,768,923,531,122,19,6532
E02002588,4432,847,1038,707,192,36,7252
E02002589,3025,777,1120,893,301,44,6160
E02002590,4016,1270,835,740,382,67,7310
E02002591,3304,1076,834,749,406,82,6451
E02002592,3378,1024,660,814,405,63,6344
E02002593,2694,704,785,561,188,27,4959
E02002594,3207,841,715,409,111,19,5302
E02002595,5814,1167,685,418,196,42,8322
E02002596,4204,1162,1273,1000,327,47,8013
E02002597,6308,1147,928,642,229,26,9280
E02002598,7335,1482,840,428,157,30,10272
E02002599,6887,1860,1273,789,287,69,11165
E02002600,5659,1321,898,653,342,76,8949
E02002601,5083,1335,917,872,489,58,8754
E02002602,6281,928,606,383,117,24,8339
E02002603,3533,1140,972,887,333,47,6912
E02002604,3849,1175,932,964,388,69,7377
E02002605,5595,1278,1043,771,320,28,9035
E02002606,8708,1380,858,603,328,104,11981
E02002607,7830,1352,997,930,434,78,11621
E02002608,4036,1256,962,1182,692,108,8236
E02002609,6962,1161,745,533,242,57,9700
E02002610,7267,1986,1394,1351,602,109,12709
E02002611,4238,1300,873,782,472,117,7782
E02002612,5048,1430,1075,891,526,160,9130
E02002613,3407,1267,792,639,286,64,6455
E02002614,2519,1099,878,736,331,53,5616
E02002615,6865,1217,855,808,459,73,10277
E02002616,6254,941,787,569,274,66,8891
E02002617,7171,864,664,349,189,24,9261
E02002618,5782,682,576,250,162,38,7490
E02002619,6686,938,716,400,194,63,8997
E02002620,6583,948,776,388,184,25,8904
E02002621,6703,809,654,316,118,14,8614
E02002622,7983,1120,855,514,183,59,10714
E02002623,7383,1262,861,611,293,53,10463
E02002624,4277,1271,1108,951,524,89,8220
E02002625,6718,1334,871,561,223,28,9735
E02002626,4223,1020,813,671,332,62,7121
E02002627,5114,1231,669,464,188,21,7687
E02002628,3982,1011,759,618,257,49,6676
E02002629,3704,793,613,406,184,12,5712
E02002630,4045,934,648,448,237,41,6353
E02002631,4754,1382,1023,890,320,39,8408
E02002632,3068,1241,924,695,215,30,6173
E02002633,3784,1135,966,1101,592,133,7711
E02002634,4087,1203,1002,1034,523,105,7954
E02002635,3943,1237,1039,1041,540,143,7943
E02002636,4900,1215,999,800,322,53,8289
E02002637,3437,967,647,597,342,56,6046
E02002638,3466,1042,769,463,211,47,5998
E02002639,4132,795,604,425,128,26,6110
E02002640,4604,993,697,386,161,36,6877
E02002641,4969,1226,846,603,378,66,8088
E02002642,4418,1151,779,492,219,60,7119
E02002643,5040,1086,731,490,194,45,7586
E02002644,4494,1137,873,732,358,70,7664
E02002645,3731,968,775,429,113,31,6047
E02002646,3820,1000,856,740,339,49,6804
E02002647,5027,1079,861,651,284,35,7937
E02002648,4446,979,811,629,259,56,7180
E02002649,4620,1282,909,805,406,111,8133
E02002650,4159,1246,1073,1028,484,93,8083
E02002651,4151,1201,942,922,524,137,7877
E02002652,11725,1630,999,435,140,19,14948
E02002653,5480,996,688,554,254,35,8007
E02002654,6095,864,567,333,201,37,8097
E02002655,6014,1118,730,610,212,26,8710
E02002656,2255,751,729,739,425,54,4953
E02002657,4118,922,986,816,310,24,7176
E02002658,3475,969,916,613,318,65,6356
E02002659,7541,1318,987,593,373,52,10864
E02002660,4114,888,831,577,251,48,6709
E02002661,5152,1011,908,616,429,114,8230
E02002662,3776,996,864,687,428,64,6815
E02002663,5428,561,513,334,115,15,6966
E02002664,3997,1121,865,724,283,29,7019
E02002665,4918,1091,917,692,295,95,8008
E02002666,7281,724,494,304,170,49,9022
E02002667,4607,964,767,511,207,43,7099
E02002668,5525,1043,840,638,307,71,8424
E02002669,6013,1005,612,327,139,20,8116
E02002670,4670,1168,815,673,395,79,7800
E02002671,5878,1244,863,523,259,52,8819
E02002672,5244,816,630,399,232,44,7365
E02002673,4822,1007,736,550,241,41,7397
E02002674,4015,938,692,549,247,28,6469
E02002675,6780,1033,769,425,165,35,9207
E02002676,5074,928,624,445,214,35,7320
E02002677,5629,1127,790,529,236,42,8353
E02002678,5514,1118,720,445,209,23,8029
E02002679,4256,1068,982,690,387,55,7438
E02002680,7248,1006,717,505,263,53,9792
E02002681,6562,1083,676,417,184,46,8968
E02002682,6421,1205,984,595,228,40,9473
E02006813,4537,1069,925,729,477,92,7829
E02002684,3744,1383,1789,1996,886,146,9944
E02002685,3108,1153,1380,1484,634,92,7851
E02002686,4640,1028,999,931,448,99,8145
E02002687,2958,912,909,784,344,72,5979
E02002688,2838,944,809,611,247,84,5533
E02002689,2420,971,1009,810,386,72,5668
E02002691,3928,1255,1251,1166,499,91,8190
E02002692,4692,1490,1303,1090,396,108,9079
E02002693,3247,1271,1167,1040,372,59,7156
E02002694,6305,1925,1585,1479,694,136,12124
E02002695,3631,1197,1366,1367,628,116,8305
E02002696,2914,1019,897,703,312,62,5907
E02002697,3610,1304,1176,1077,459,52,7678
E02002698,4706,1176,1126,997,428,72,8505
E02002699,4979,1517,1299,1208,604,127,9734
E02002700,3895,874,667,544,293,39,6312
E02002701,4150,1506,1364,962,365,77,8424
E02002702,5075,1605,1425,1151,653,151,10060
E02002703,4491,1642,1281,967,496,87,8964
E02002704,3152,1197,1264,1073,391,50,7127
E02002705,2850,1012,1003,935,529,91,6420
E02002706,3684,1165,988,787,448,91,7163
E02002707,3669,1289,1016,888,406,63,7331
E02002708,3250,850,919,841,612,146,6618
E02002709,4169,1319,1086,870,402,74,7920
E02002710,3890,1195,925,834,506,97,7447
E02002711,3446,1201,1107,1084,669,123,7630
E02002712,3658,1147,1163,1067,486,89,7610
E02002714,3646,1300,1354,1076,387,60,7823
E02002715,8361,2058,1301,1124,565,94,13503
E02002716,4500,1293,1171,1074,463,60,8561
E02002717,4712,1096,927,718,417,86,7956
E02002718,3827,1246,1135,1083,589,79,7959
E02002719,3336,1063,795,610,424,107,6335
E02002720,4035,1198,1063,784,402,84,7566
E02002721,3247,1128,936,686,329,91,6417
E02002722,4259,1272,1414,1185,481,88,8699
E02002723,5395,1190,935,789,425,110,8844
E02002724,6663,1226,947,626,261,35,9758
E02002725,3520,1131,927,773,311,47,6709
E02006814,4501,1180,1102,886,395,72,8136
E02006891,3845,1283,1119,938,435,82,7702
E02006892,3402,949,778,765,362,125,6381
E02002726,6079,1464,1324,1077,441,103,10488
E02002727,3557,804,564,336,210,45,5516
E02002728,5324,1003,674,444,205,40,7690
E02002729,3256,911,762,623,221,30,5803
E02002730,5411,951,625,366,154,42,7549
E02002731,4482,732,480,244,109,17,6064
E02002732,4344,1247,1025,781,417,80,7894
E02002733,3396,856,675,500,276,45,5748
E02002734,3410,693,575,519,265,52,5514
E02002735,3142,747,566,340,210,40,5045
E02002736,4470,739,431,226,113,15,5994
E02002737,4141,1110,864,585,356,98,7154
E02002738,4098,1015,916,669,242,41,6981
E02002739,3349,823,727,531,347,51,5828
E02002740,3452,728,626,429,254,55,5544
E02002741,5485,1212,990,727,469,124,9007
E02002742,2843,792,804,732,373,48,5592
E02002743,2356,781,791,935,534,144,5541
E02002744,5054,852,735,390,169,34,7234
E02002745,3012,1276,1035,1219,559,116,7217
E02002746,5581,1351,1123,1020,564,124,9763
E02002747,4387,1371,1049,1102,538,100,8547
E02002748,3531,1302,1235,1056,571,155,7850
E02002749,6584,1720,1589,1196,489,92,11670
E02002750,3295,1104,899,692,265,53,6308
E02002751,3505,974,850,815,286,45,6475
E02002752,3728,1227,1076,719,304,43,7097
E02002753,4236,1289,1328,1117,585,105,8660
E02002754,4567,1398,1158,834,386,69,8412
E02002755,5401,1018,732,464,216,68,7899
E02002756,7331,1027,665,358,189,48,9618
E02002757,4133,836,637,500,288,76,6470
E02002758,4131,872,678,387,180,32,6280
E02002759,4722,1576,1432,1162,528,125,9545
E02002760,3273,968,781,568,261,82,5933
E02002761,3378,1165,890,739,353,64,6589
E02002762,4058,976,723,508,318,118,6701
E02002763,6131,1096,764,500,245,83,8819
E02002764,4112,735,554,410,189,37,6037
E02002765,3846,862,717,568,313,63,6369
E02002766,5350,1147,1066,919,443,124,9049
E02002767,3244,1031,994,861,389,83,6602
E02002768,3961,1262,1177,832,391,63,7686
E02002769,2526,1035,870,847,383,63,5724
E02002770,3733,1078,1035,815,330,66,7057
E02002771,3438,1270,1112,1000,399,73,7292
E02002772,4089,1128,807,622,253,72,6971
E02002773,2689,718,891,902,443,101,5744
E02002774,2940,835,934,794,441,155,6099
E02002775,2906,788,715,759,468,116,5752
E02002776,3950,966,726,748,418,64,6872
E02002777,5510,1295,907,570,198,28,8508
E02002778,4754,1304,915,809,495,130,8407
E02002779,5287,1423,1174,1085,638,116,9723
E02002780,6418,917,619,462,227,26,8669
E02002781,8907,1019,672,487,289,70,11444
E02002782,3351,936,731,748,498,110,6374
E02002783,6332,1478,1179,895,508,77,10469
E02002784,10161,1235,1011,674,326,68,13475
E02002785,5322,1037,781,687,497,81,8405
E02002786,9176,933,586,435,188,26,11344
E02002787,5972,1203,929,710,455,100,9369
E02002788,6311,1171,791,554,214,48,9089
E02002789,6283,1106,832,605,319,84,9229
E02002790,10137,1146,823,634,326,101,13167
E02002791,3331,974,795,855,405,119,6479
E02002792,4809,1069,835,625,362,101,7801
E02002793,5227,1290,1181,1066,460,118,9342
E02002794,7183,735,624,616,329,103,9590
E02002795,4061,1233,1246,1193,463,100,8296
E02002796,3217,886,739,778,357,70,6047
E02002797,3496,1022,905,1003,763,149,7338
E02002798,5610,1663,1179,728,305,82,9567
E02002799,4066,815,455,374,222,25,5957
E02002800,4175,962,708,672,419,140,7076
E02002801,4459,1065,754,698,427,70,7473
E02002802,5540,1024,680,455,241,42,7982
E02002803,6465,768,616,388,200,35,8472
E02002804,5720,1122,768,594,356,163,8723
E02002805,2589,844,701,881,412,53,5480
E02002806,4986,590,387,242,116,24,6345
E02002807,5276,1226,879,868,345,81,8675
E02002808,10608,1100,666,395,242,45,13056
E02002809,4011,917,674,663,305,111,6681
E02002810,4586,1225,1070,920,540,91,8432
E02002811,8846,1197,753,299,195,43,11333
E02002812,4674,1011,773,613,385,119,7575
E02002813,9398,1106,686,355,244,62,11851
E02002814,3431,1041,1054,857,489,128,7000
E02002815,6840,874,482,315,216,62,8789
E02002816,6123,1419,958,619,319,65,9503
E02002817,3579,845,752,600,380,76,6232
E02002818,6323,907,610,430,332,92,8694
E02002819,5094,1125,754,580,303,70,7926
E02002820,6694,1268,802,597,278,53,9692
E02002821,9189,1333,765,512,289,64,12152
E02002822,4031,908,678,541,397,65,6620
E02002823,4188,1061,777,858,397,58,7339
E02002824,6808,1145,947,615,223,53,9791
E02002825,5305,1103,852,803,385,132,8580
E02002826,4357,1129,681,473,246,35,6921
E02002827,4348,839,628,339,111,43,6308
E02002828,4748,965,1050,628,295,41,7727
E02002829,8122,1314,853,536,346,115,11286
E02002830,7447,1056,908,447,177,44,10079
E02002831,4302,834,822,517,278,56,6809
E02002832,5934,1086,1113,608,337,81,9159
E02002833,5623,1075,932,468,213,29,8340
E02002834,7864,1177,1004,736,386,89,11256
E02002835,10724,1530,1170,597,313,59,14393
E02002836,6211,1206,1150,621,316,43,9547
E02002837,6456,946,624,316,123,12,8477
E02002838,5749,889,621,499,242,49,8049
E02002839,5100,990,817,569,295,92,7863
E02002842,6975,846,460,198,88,18,8585
E02002843,10731,1418,1183,555,266,32,14185
E02002844,8838,1185,817,501,230,55,11626
E02002845,7650,1258,996,562,304,92,10862
E02002846,4296,1092,822,587,279,77,7153
E02002847,7253,1098,925,442,247,44,10009
E02002848,8790,999,816,449,195,27,11276
E02002849,12369,1020,643,423,217,66,14738
E02002851,4895,1049,1064,701,477,132,8318
E02002852,5218,800,543,285,139,22,7007
E02002853,9771,1371,1094,584,337,63,13220
E02002854,5833,1011,653,423,281,66,8267
E02002855,6333,737,532,318,141,18,8079
E02002856,8674,1107,851,653,374,132,11791
E02002857,4958,754,469,254,143,35,6613
E02002858,4026,1046,808,663,397,91,7031
E02002860,4794,1041,839,693,405,120,7892
E02002861,5438,892,643,360,177,37,7547
E02002862,5431,939,715,575,303,67,8030
E02006815,7068,1238,996,668,466,157,10593
E02006817,6414,937,677,466,261,73,8828
E02006819,5836,938,638,436,201,54,8103
E02006850,12494,530,299,153,110,17,13603
E02006851,10983,311,195,62,20,4,11575
E02002863,4624,1049,944,828,323,62,7830
E02002864,4518,1126,1011,840,423,93,8011
E02002865,4057,1089,1024,1056,530,119,7875
E02002866,3814,1224,1032,981,476,107,7634
E02002867,4342,1365,1143,1032,546,149,8577
E02002868,3213,794,675,725,307,30,5744
E02002869,5023,950,703,510,280,60,7526
E02002871,4637,1166,839,663,354,64,7723
E02002872,5863,1192,839,623,232,41,8790
E02002873,7011,1127,687,393,254,41,9513
E02002874,5633,1043,762,466,247,87,8238
E02002875,6054,1097,674,498,227,53,8603
E02002876,5317,1171,821,555,265,47,8176
E02002877,4861,984,825,612,332,116,7730
E02002878,7805,947,548,292,113,18,9723
E02002879,7348,1135,688,405,140,25,9741
E02002880,6898,1029,548,419,139,25,9058
E02002881,4824,884,555,361,176,63,6863
E02002882,6036,1050,739,413,256,95,8589
E02002883,5623,1022,694,399,186,27,7951
E02002884,5564,676,374,192,121,41,6968
E02002885,7648,787,455,240,55,15,9200
E02002886,6874,1018,878,574,354,71,9769
E02002887,3837,879,751,670,340,106,6583
E02002888,5524,884,634,329,185,21,7577
E02002889,11894,569,339,132,69,17,13020
E02002890,11788,938,607,359,180,40,13912
E02002891,5430,1013,829,535,324,59,8190
E02002892,3961,849,563,394,248,59,6074
E02002893,14238,875,579,274,113,22,16101
E02002894,4416,878,777,546,328,89,7034
E02002895,7182,530,371,249,92,14,8438
E02002896,8403,1011,657,372,175,45,10663
E02002897,4646,1107,891,854,551,124,8173
E02002898,9880,381,329,172,128,24,10914
E02002899,9517,493,467,320,179,43,11019
E02002901,3701,855,723,519,299,70,6167
E02002902,6300,1066,965,458,339,138,9266
E02002903,3722,739,790,477,416,88,6232
E02002904,3934,805,614,341,249,92,6035
E02006834,4694,1023,744,606,423,53,7543
E02006904,11262,510,324,138,17,21,12272
E02006905,5819,840,582,343,164,34,7782
E02002905,2891,1101,1094,986,336,56,6464
E02002906,3397,745,722,668,416,157,6105
E02002907,3568,835,846,695,300,52,6296
E02002908,4033,1448,1512,1308,540,88,8929
E02002909,5146,1670,1799,1364,623,166,10768
E02002910,3761,1312,1351,1154,539,110,8227
E02002911,5060,1352,1340,1145,599,114,9610
E02002912,4202,1205,1036,811,355,62,7671
E02002913,2442,952,1039,926,374,95,5828
E02002914,5408,1347,1089,889,485,76,9294
E02002915,4231,1142,895,791,521,170,7750
E02002916,6549,1378,993,699,372,77,10068
E02002917,4455,998,710,601,332,78,7174
E02002918,3128,873,808,671,419,92,5991
E02002919,6490,1203,935,734,333,84,9779
E02002920,3857,1027,842,702,278,73,6779
E02002921,5805,1027,740,452,210,36,8270
E02002922,3371,1090,1060,880,389,70,6860
E02002923,5124,1478,1190,1327,732,203,10054
E02002924,2916,1066,946,847,393,78,6246
E02002925,6039,1824,1568,1212,531,95,11269
E02002926,5879,1542,1555,1373,772,188,11309
E02002927,5335,2151,2014,1698,710,152,12060
E02002928,3408,896,740,647,235,56,5982
E02002929,3494,943,811,735,302,73,6358
E02002930,3771,757,697,711,364,72,6372
E02002931,3876,1120,766,695,284,21,6762
E02002932,6415,1101,792,615,249,47,9219
E02002933,4283,1371,908,814,423,71,7870
E02002934,3582,937,844,450,186,29,6028
E02002935,3770,899,798,720,309,38,6534
E02002936,7829,1203,735,482,179,37,10465
E02002937,5204,1820,1394,1128,437,77,10060
E02002938,4897,900,711,482,207,40,7237
E02002939,3926,1017,829,699,404,89,6964
E02002940,3424,902,677,552,265,36,5856
E02002941,6491,1449,1118,950,394,82,10484
E02002942,4754,1062,837,440,216,44,7353
E02002943,11179,1662,1062,625,254,76,14858
E02002944,5583,1048,789,539,224,31,8214
E02002945,6564,1287,969,623,223,24,9690
E02002946,4603,1233,909,621,289,37,7692
E02002947,4895,856,690,526,163,33,7163
E02002948,5694,802,530,386,134,14,7560
E02002949,2914,845,718,594,257,37,5365
E02002950,3616,707,627,564,220,34,5768
E02002951,4172,1136,1072,799,346,90,7615
E02002952,5038,923,659,536,295,44,7495
E02002953,4364,929,844,852,322,62,7373
E02002954,4948,1178,936,733,351,47,8193
E02002955,5679,820,569,405,191,37,7701
E02002956,6090,1247,914,642,299,59,9251
E02002957,5251,1400,1166,1093,579,77,9566
E02002958,5285,1049,848,682,322,54,8240
E02002959,6785,1033,734,544,290,47,9433
E02002960,3283,907,822,516,210,28,5766
E02002961,5097,767,525,426,175,26,7016
E02002962,4587,961,759,614,303,49,7273
E02002963,4961,957,648,435,218,28,7247
E02002964,4606,1198,1100,1036,489,65,8494
E02002965,6783,786,482,266,132,20,8469
E02002966,8172,664,629,431,185,39,10120
E02002967,7249,1238,937,528,325,62,10339
E02002968,6130,1221,863,633,325,72,9244
E02002969,6741,1068,764,585,262,36,9456
E02002970,5425,1133,730,618,199,38,8143
E02002971,2900,741,697,399,108,9,4854
E02002972,3986,824,688,566,192,36,6292
E02002973,5661,1108,804,522,259,36,8390
E02002974,3160,827,791,743,369,88,5978
E02002975,4016,1140,938,726,220,32,7072
E02002976,3694,856,636,559,252,19,6016
E02002977,2786,799,826,828,395,68,5702
E02002978,4667,762,621,455,231,37,6773
E02002979,4329,582,523,364,188,31,6017
E02002980,3014,811,810,828,433,97,5993
E02002981,5688,1189,770,545,215,22,8429
E02002982,5556,933,795,432,208,51,7975
E02002983,2680,818,690,657,208,30,5083
E02002984,2684,810,871,679,268,55,5367
E02002985,3881,755,641,635,384,113,6409
E02002986,4004,698,582,603,332,86,6305
E02002987,2995,745,690,699,435,83,5647
E02002988,3310,806,645,536,311,89,5697
E02002989,3433,772,545,488,412,91,5741
E02002990,4100,792,585,447,156,18,6098
E02002991,7556,1279,972,874,508,129,11318
E02002992,3777,790,576,481,291,65,5980
E02002993,5014,660,500,305,164,54,6697
E02002994,5579,1688,1326,1169,651,132,10545
E02002995,4184,706,402,323,138,29,5782
E02002996,10263,988,929,743,351,95,13369
E02002997,6162,559,461,386,199,40,7807
E02002998,4263,640,396,347,214,59,5919
E02002999,3501,658,578,507,279,54,5577
E02003000,4795,1454,1452,1240,591,127,9659
E02003001,3143,842,690,491,298,97,5561
E02003002,3754,739,637,480,238,89,5937
E02003003,4013,704,547,446,244,86,6040
E02003004,3774,1090,860,689,312,56,6781
E02003005,3422,1033,884,796,303,64,6502
E02003006,6188,1378,976,788,349,86,9765
E02003007,5624,1269,1050,859,403,85,9290
E02003008,4026,840,583,429,239,34,6151
E02003009,3678,913,652,574,351,70,6238
E02003010,4422,898,690,478,231,50,6769
E02003011,3207,764,608,707,350,62,5698
E02003012,7714,1297,1060,890,392,120,11473
E02003013,8301,1323,989,864,395,106,11978
E02003014,6111,818,630,445,245,47,8296
E02003015,4703,717,558,425,246,44,6693
E02003016,6391,732,534,340,178,41,8216
E02003017,3524,710,622,664,384,176,6080
E02003018,3662,772,680,518,211,67,5910
E02003019,6408,1307,943,747,362,101,9868
E02003020,3723,748,683,678,444,234,6510
E02003021,5899,603,451,327,204,70,7554
E02003022,3372,762,703,587,398,81,5903
E02003023,4296,773,717,510,271,97,6664
E02003024,6727,1018,769,619,387,180,9700
E02003025,5408,829,598,440,251,75,7601
E02003026,5731,1004,1007,899,546,148,9335
E02003027,9784,1288,907,519,190,55,12743
E02003028,5858,1068,715,513,289,88,8531
E02003029,4564,753,504,337,167,48,6373
E02003030,5688,887,666,366,157,27,7791
E02003031,8210,1140,734,388,138,39,10649
E02003032,5937,815,641,444,238,52,8127
E02003033,7387,633,420,366,112,55,8973
E02003034,11059,1177,713,336,159,22,13466
E02003036,8830,618,431,240,135,52,10306
E02003037,7415,593,469,317,177,42,9013
E02003038,4452,802,553,426,232,47,6512
E02003039,6213,1030,679,536,226,66,8750
E02003040,7616,938,559,404,279,92,9888
E02003041,4478,528,473,434,210,29,6152
E02003043,17287,649,456,409,131,17,18949
E02003044,3769,726,533,491,236,18,5773
E02003045,5858,549,498,389,118,15,7427
E02003046,7257,1096,709,490,219,67,9838
E02003047,8394,1105,753,465,299,85,11101
E02003048,5593,677,469,247,96,20,7102
E02003049,5043,909,665,655,285,61,7618
E02003050,7585,874,679,447,290,74,9949
E02003051,5908,690,420,273,108,16,7415
E02003052,4852,697,563,457,215,59,6843
E02003053,5445,1032,801,546,283,88,8195
E02003054,4383,867,623,471,187,45,6576
E02003055,6130,956,660,420,226,26,8418
E02003056,5295,840,730,443,202,26,7536
E02003057,3747,708,606,514,281,76,5932
E02003058,5804,1069,925,741,398,114,9051
E02003059,4060,724,602,378,314,66,6144
E02003060,6243,1355,1163,1030,621,147,10559
E02003061,4138,702,578,367,221,48,6054
E02003062,4011,701,511,329,285,52,5889
E02003063,3708,868,929,843,402,57,6807
E02003064,5147,850,530,316,256,34,7133
E02006887,8410,639,364,200,73,27,9713
E02006888,5787,663,398,199,149,46,7242
E02006889,6625,650,451,275,175,26,8202
E02006890,6914,936,486,312,182,26,8856
E02003065,5566,1348,1115,1149,572,136,9886
E02003066,2884,993,952,918,343,85,6175
E02003067,4983,1003,786,732,348,86,7938
E02003068,3372,931,776,785,330,95,6289
E02003069,2523,886,801,776,490,135,5611
E02003070,8122,1821,1485,1385,689,129,13631
E02003071,4240,1198,1014,891,585,175,8103
E02003072,4385,1314,1193,1324,785,124,9125
E02003073,3224,994,902,906,313,82,6421
E02003074,4490,1110,984,727,342,75,7728
E02003075,3285,986,723,700,303,52,6049
E02003076,5100,1484,1199,1083,478,90,9434
E02003077,3280,954,798,737,381,32,6182
E02003078,3740,1102,961,966,360,66,7195
E02003079,5572,1368,1181,845,316,57,9339
E02003080,4394,1137,1123,1330,628,138,8750
E02003081,4720,1429,1227,1351,604,132,9463
E02003082,4595,1474,1163,1088,671,238,9229
E02003084,6434,1521,1090,877,554,167,10643
E02003085,5299,1154,716,480,244,37,7930
E02003086,3080,949,764,686,508,191,6178
E02003087,5079,1442,1498,1499,618,84,10220
E02003088,4007,1257,1230,1194,577,179,8444
E02003089,3055,854,780,821,360,73,5943
E02006845,6772,1147,884,672,320,102,9897
E02006846,7366,955,506,288,117,17,9249
E02003090,4777,1058,882,905,445,95,8162
E02003091,3540,1023,772,835,415,73,6658
E02003092,4558,1570,1020,739,295,38,8220
E02003093,2934,1033,923,948,515,108,6461
E02003094,5278,1352,1013,843,357,91,8934
E02003095,4397,1214,898,704,278,45,7536
E02003096,3866,945,630,596,212,45,6294
E02003097,3214,899,812,954,453,111,6443
E02003098,7606,1441,740,385,117,17,10306
E02003099,4383,987,808,803,424,61,7466
E02003100,9556,1706,1175,1040,503,97,14077
E02003101,8192,1621,801,435,159,79,11287
E02003102,4039,1082,706,742,398,54,7021
E02003103,5044,932,646,512,118,19,7271
E02003104,4591,1143,908,634,278,46,7600
E02003105,3283,995,696,793,475,110,6352
E02003106,12525,1472,791,643,358,144,15933
E02003107,7836,1186,860,863,470,113,11328
E02003108,6685,1709,1215,1028,518,94,11249
E02003109,3513,877,638,662,384,89,6163
E02003110,8616,1641,883,668,295,41,12144
E02003111,3727,916,729,678,451,138,6639
E02003112,4226,820,675,548,329,81,6679
E02003113,5491,1900,1483,1166,534,117,10691
E02003114,4083,982,747,730,552,85,7179
E02003115,6568,1164,952,742,415,124,9965
E02003116,4838,939,760,705,465,79,7786
E02003117,6167,1205,867,739,358,72,9408
E02003118,6292,1609,1099,732,335,48,10115
E02003119,6415,1533,1166,867,421,87,10489
E02003120,5128,1407,1008,962,610,105,9220
E02003121,5158,1443,1454,1175,624,163,10017
E02003122,3462,996,1010,1042,443,90,7043
E02003123,5344,1185,917,767,427,61,8701
E02003124,5297,1054,750,578,322,58,8059
E02003125,3444,926,773,621,256,58,6078
E02003126,4690,835,1244,789,267,87,7912
E02003127,4694,1005,744,648,284,39,7414
E02003128,5442,1210,947,773,362,74,8808
E02003129,3438,856,757,695,378,48,6172
E02003130,6456,1433,1233,843,390,62,10417
E02003131,4363,933,835,827,320,49,7327
E02003132,5575,1194,945,787,378,77,8956
E02003133,4008,1105,854,822,321,55,7165
E02003134,4329,967,692,492,252,44,6776
E02003135,5544,934,600,411,164,17,7670
E02003136,3814,1081,951,1090,642,150,7728
E02003137,4072,1235,916,836,547,204,7810
E02003138,4999,1100,679,467,238,53,7536
E02003139,4324,942,647,493,145,17,6568
E02003140,4411,1129,798,766,469,94,7667
E02003141,5198,1184,751,510,240,51,7934
E02003142,5732,1263,986,703,350,71,9105
E02003143,4233,990,974,745,308,96,7346
E02003144,7330,523,426,313,200,70,8862
E02003145,4205,978,715,546,293,90,6827
E02003146,6799,792,537,407,185,34,8754
E02003147,6664,1125,821,527,175,28,9340
E02003148,8238,803,765,514,238,46,10604
E02003149,7259,886,708,446,168,39,9506
E02003150,8253,1531,1235,812,430,102,12363
E02003151,3632,1100,992,1149,712,179,7764
E02003152,5784,1548,1242,1187,546,113,10420
E02003153,4125,1020,873,869,494,87,7468
E02003154,3992,1051,848,849,438,46,7224
E02003155,2920,814,750,758,426,112,5780
E02003156,6581,1460,1177,930,354,68,10570
E02003157,3833,982,810,559,197,32,6413
E02003158,2793,733,756,784,423,131,5620
E02003159,3668,847,579,470,214,55,5833
E02003161,4572,1143,982,557,288,67,7609
E02003163,2636,1336,1417,1437,767,251,7844
E02003164,4157,1326,1269,1259,641,170,8822
E02003165,3853,1069,892,818,382,96,7110
E02003166,7409,1654,1351,1123,439,76,12052
E02003167,4545,1518,1322,1168,774,218,9545
E02003168,3259,1151,1069,1075,501,92,7147
E02003169,2472,984,1251,1276,644,141,6768
E02003170,3752,1455,1625,1748,737,142,9459
E02003171,3459,1173,1158,1078,511,144,7523
E02006840,5972,1584,1448,1291,512,138,10945
E02003212,4034,1213,1190,1091,504,87,8119
E02003214,4205,778,598,378,214,42,6215
E02003215,3221,1086,934,967,384,58,6650
E02003216,5094,1444,1124,1040,473,82,9257
E02003217,4513,991,729,587,239,66,7125
E02003218,4045,883,703,467,215,43,6356
E02003219,5587,1400,1107,731,324,87,9236
E02003220,5324,1750,1167,907,711,140,9999
E02003221,4787,968,682,423,198,36,7094
E02003222,3695,1067,644,289,111,5,5811
E02003223,7453,1332,897,545,261,62,10550
E02003224,4276,1350,1102,958,543,94,8323
E02003225,3676,1000,765,352,135,23,5951
E02003226,8096,1245,689,366,148,19,10563
E02003227,4640,954,589,322,176,32,6713
E02003228,5032,1059,704,458,294,75,7622
E02003229,3347,995,682,283,61,11,5379
E02003230,6767,875,552,313,170,44,8721
E02003231,5833,1179,751,577,332,48,8720
E02003232,5842,1226,768,506,242,73,8657
E02003233,5207,1211,1128,704,283,65,8598
E02003234,4482,1286,1117,826,356,58,8125
E02003235,5528,1205,984,810,494,134,9155
E02003236,6509,1730,1395,1333,711,188,11866
E02006847,7441,1197,537,292,122,39,9628
E02006848,6720,814,374,193,36,17,8154
E02006849,6735,1453,758,445,172,43,9606
E02003237,2807,1021,829,701,348,62,5768
E02003238,3468,936,649,332,144,38,5567
E02003239,3824,1208,1031,839,381,91,7374
E02003240,4453,946,650,502,208,29,6788
E02003241,3908,983,748,665,231,40,6575
E02003242,4234,1168,994,924,512,121,7953
E02003243,7750,1181,876,491,279,54,10631
E02003244,6404,1149,777,629,430,74,9463
E02003245,5809,785,655,394,155,38,7836
E02003246,7774,1072,616,368,196,24,10050
E02003247,5605,1024,809,645,256,31,8370
E02003248,8282,1214,819,465,332,110,11222
E02003249,8647,1389,961,687,353,53,12090
E02003250,9576,1217,845,415,300,117,12470
E02003251,3716,976,1032,910,479,132,7245
E02003252,9817,1289,777,459,283,63,12688
E02003253,6947,1148,802,576,289,77,9839
E02003254,4532,1351,1225,941,461,90,8600
E02003255,7698,1389,1104,886,500,96,11673
E02003257,6305,1041,846,491,209,41,8933
E02006877,6887,1109,757,623,293,56,9725
E02006878,9277,1199,480,230,147,66,11399
E02003258,4608,1299,1055,855,358,82,8257
E02003259,3929,862,615,459,260,46,6171
E02003260,5910,1031,703,483,164,23,8314
E02003261,3337,836,628,671,426,89,5987
E02003262,6633,1343,959,700,396,97,10128
E02003263,8151,1438,934,808,589,112,12032
E02003264,6071,1236,886,568,394,93,9248
E02003265,4476,1169,940,764,390,61,7800
E02003266,6215,1310,770,462,343,73,9173
E02003267,10886,1223,804,475,280,60,13728
E02003268,9027,1164,754,484,327,78,11834
E02003269,6741,1368,939,720,446,90,10304
E02003270,5250,1095,702,574,463,70,8154
E02003271,6320,1487,1013,529,223,49,9621
E02003272,8158,853,665,314,229,32,10251
E02003273,7504,1368,960,581,321,63,10797
E02003274,9312,829,561,313,222,44,11281
E02003275,13143,1264,751,382,238,58,15836
E02003276,7378,741,510,245,170,45,9089
E02003277,8131,1189,877,459,311,63,11030
E02003278,11201,1366,753,439,214,44,14017
E02003279,4959,1372,1180,1217,644,139,9511
E02003280,5911,1491,1290,1105,526,128,10451
E02003281,4736,1378,1255,1390,663,204,9626
E02003282,6223,1526,1190,1058,513,134,10644
E02003283,6771,1490,1251,973,506,151,11142
E02003284,7347,1666,1147,746,343,76,11325
E02003285,8115,1456,907,500,180,33,11191
E02003286,5454,1375,1070,947,465,131,9442
E02003287,5704,1381,1103,1082,652,161,10083
E02003288,9230,1580,962,665,341,111,12889
E02003289,6745,1457,957,779,415,112,10465
E02003290,6368,1424,1093,765,582,285,10517
E02003291,7339,1747,1320,1128,415,45,11994
E02003292,8787,1580,1045,615,250,66,12343
E02003293,7831,1495,931,808,496,142,11703
E02003294,4556,1397,1195,1270,688,168,9274
E02003295,6201,1542,1170,1016,474,122,10525
E02003296,3613,1040,936,825,353,37,6804
E02003297,4203,937,799,781,375,68,7163
E02003298,3838,996,788,752,380,62,6816
E02003299,3244,1041,754,617,285,48,5989
E02003300,5645,1022,841,683,287,25,8503
E02003301,8060,1446,1042,729,235,59,11571
E02003302,7635,1426,881,510,226,54,10732
E02003303,6346,1194,842,542,209,54,9187
E02003304,6039,1307,1036,860,418,124,9784
E02003305,4100,829,763,650,305,61,6708
E02003307,6545,1406,985,781,513,108,10338
E02003308,4922,937,738,475,126,36,7234
E02003309,4685,1099,852,668,281,47,7632
E02003310,12424,1525,806,379,132,16,15282
E02003311,6735,1183,659,456,251,67,9351
E02003312,8257,1027,447,246,91,11,10079
E02003313,10918,1713,1064,692,294,67,14748
E02006859,6643,1006,313,155,38,8,8163
E02006926,6172,1138,545,287,102,13,8257
E02003314,3269,1005,972,794,276,59,6375
E02003315,3271,841,673,577,211,20,5593
E02003316,6917,1536,1127,983,359,51,10973
E02003317,4201,971,724,562,314,59,6831
E02003318,3346,967,725,617,285,34,5974
E02003319,5946,1073,695,467,236,39,8456
E02003320,6975,1069,654,376,140,28,9242
E02003321,4293,858,630,515,242,31,6569
E02003322,6530,786,507,294,165,23,8305
E02003323,5502,1023,580,363,185,40,7693
E02003324,7158,1104,801,547,223,29,9862
E02003325,5922,854,538,309,127,24,7774
E02003326,5465,1092,706,524,183,51,8021
E02003327,5085,1021,616,533,225,55,7535
E02003328,7494,1143,640,367,134,49,9827
E02003329,5218,858,585,320,127,31,7139
E02003330,4592,893,639,424,179,19,6746
E02003331,5273,1371,1015,743,365,88,8855
E02003332,3781,985,703,487,253,91,6300
E02003333,5622,870,484,299,152,30,7457
E02003334,4310,808,503,342,167,49,6179
E02003335,5909,835,453,260,103,32,7592
E02003336,3270,877,793,675,401,60,6076
E02003337,4653,1019,682,511,297,69,7231
E02003338,4541,944,764,637,266,46,7198
E02003339,3736,1008,725,601,335,86,6491
E02003340,5009,1171,879,570,303,71,8003
E02003341,3935,1013,716,674,231,27,6596
E02003342,3574,875,795,708,345,56,6353
E02003343,2925,910,844,840,322,73,5914
E02003344,4563,975,886,481,187,26,7118
E02003345,3848,802,733,491,173,5,6052
E02003346,4104,987,743,713,339,64,6950
E02003347,4290,886,517,319,93,21,6126
E02003348,3962,1109,1130,1013,472,95,7781
E02003349,4268,892,859,855,345,69,7288
E02003350,3860,870,667,561,278,39,6275
E02003351,4879,1086,830,742,235,34,7806
E02003352,2947,1074,739,727,323,51,5861
E02003353,6561,1636,1085,632,322,70,10306
E02003354,6314,1723,1003,561,271,90,9962
E02003355,4672,909,566,331,210,61,6749
E02003356,4360,1179,824,512,337,67,7279
E02003357,7299,1186,767,507,387,58,10204
E02003358,8093,1419,852,565,324,88,11341
E02003359,4561,957,609,262,92,32,6513
E02003360,8547,1374,954,714,211,17,11817
E02003361,4833,1058,749,487,216,42,7385
E02003362,4548,877,731,501,145,24,6826
E02003363,4414,986,706,662,377,118,7263
E02003364,4298,1078,714,509,136,23,6758
E02003365,3954,1052,821,603,286,59,6775
E02003366,5054,986,763,449,209,49,7510
E02003367,3754,1076,768,611,200,42,6451
E02003368,3094,929,749,638,232,47,5689
E02003369,3604,1084,792,616,327,79,6502
E02003370,3637,1073,867,714,305,65,6661
E02003371,3086,971,730,563,311,41,5702
E02003372,4358,1169,928,747,366,60,7628
E02003373,5387,1364,849,713,281,67,8661
E02003374,3420,846,739,381,137,34,5557
E02003375,3510,901,704,485,251,39,5890
E02003376,3194,891,724,674,301,63,5847
E02003377,5967,1601,1360,951,395,62,10336
E02003378,4391,1049,915,844,466,162,7827
E02003379,4607,937,592,470,239,67,6912
E02003380,4763,1184,957,628,244,40,7816
E02003381,3653,880,627,509,199,61,5929
E02003382,4932,1233,757,647,312,91,7972
E02003383,4334,1073,737,434,186,25,6789
E02003384,3370,1138,888,729,314,73,6512
E02003385,7190,1190,852,641,317,73,10263
E02003386,5222,1115,840,718,271,72,8238
E02003387,5545,1318,1053,1004,460,72,9452
E02003388,3289,900,697,610,268,52,5816
E02003389,4284,1060,796,798,382,84,7404
E02003390,4000,1195,849,682,347,74,7147
E02003391,4874,1087,816,686,417,121,8001
E02003392,5577,937,600,423,242,60,7839
E02003393,4335,1171,859,690,343,82,7480
E02003394,5640,969,668,399,251,46,7973
E02003395,8136,1089,520,286,123,32,10186
E02003396,6511,1163,686,454,258,52,9124
E02003397,4488,1040,746,661,348,104,7387
E02003398,8421,1011,561,410,145,23,10571
E02003399,12487,1088,599,391,103,15,14683
E02003400,6362,761,460,295,207,78,8163
E02003401,6100,982,717,442,355,101,8697
E02003402,8419,931,558,339,171,32,10450
E02003403,5348,1234,847,716,410,86,8641
E02003404,7770,656,490,369,212,53,9550
E02003405,8517,1355,801,445,211,33,11362
E02003406,4595,1040,781,460,200,46,7122
E02003407,7524,1249,690,314,242,51,10070
E02003408,8129,1199,919,456,246,33,10982
E02003409,7066,1330,843,458,219,41,9957
E02003410,8679,1163,928,474,247,54,11545
E02003411,8413,1150,857,498,314,97,11329
E02003412,6896,1248,806,576,243,51,9820
E02003413,10355,1295,968,478,254,51,13401
E02003414,10201,1387,887,514,164,43,13196
E02003415,10384,1128,740,409,225,76,12962
E02003416,6655,1104,742,474,249,46,9270
E02003417,8619,1234,863,472,266,46,11500
E02003418,7351,1214,854,389,235,73,10116
E02003419,6289,1083,685,500,239,47,8843
E02003420,4906,803,467,240,114,18,6548
E02003421,3246,815,631,542,311,61,5606
E02003422,6009,1983,1383,1278,629,170,11452
E02003423,4288,822,609,494,211,46,6470
E02003424,5112,1295,992,926,504,131,8960
E02003425,9548,1385,933,679,435,123,13103
E02003426,5869,1563,990,747,454,163,9786
E02003427,5825,964,614,493,263,61,8220
E02003428,5611,1305,1024,833,306,49,9128
E02003429,4394,1150,897,780,357,94,7672
E02003430,4631,1076,650,409,251,48,7065
E02003431,4161,1040,679,543,255,89,6767
E02003432,5009,892,535,434,284,75,7229
E02003433,3996,820,633,680,412,83,6624
E02003434,5779,1267,836,650,417,164,9113
E02003435,4570,1089,628,602,278,45,7212
E02003436,4545,1419,1048,917,493,129,8551
E02003437,4368,1238,836,701,309,102,7554
E02003438,6055,1802,1149,1047,655,202,10910
E02003439,2965,877,699,650,308,100,5599
E02003440,5694,1301,923,818,435,97,9268
E02003441,4165,1217,918,791,488,102,7681
E02003442,5093,1269,736,499,203,51,7851
E02003443,4569,833,601,645,507,88,7243
E02003444,6475,1284,893,670,408,84,9814
E02003445,5355,1236,852,826,418,35,8722
E02003446,6746,1327,887,782,326,77,10145
E02003447,7048,1366,898,601,335,89,10337
E02003448,4511,1098,822,672,294,68,7465
E02003449,5437,1095,718,361,158,40,7809
E02003450,8651,1492,1117,690,306,82,12338
E02003451,5545,1087,827,825,598,204,9086
E02003452,5651,1162,748,647,309,56,8573
E02003453,3913,1149,843,564,215,31,6715
E02003454,5421,1164,915,757,395,149,8801
E02003455,5565,1173,882,657,271,71,8619
E02003456,4655,962,602,468,267,30,6984
E02003457,5508,1752,1327,997,349,72,10005
E02003458,4474,1366,926,852,379,67,8064
E02003459,4420,1315,1141,914,478,104,8372
E02003460,6353,1529,1335,1043,424,80,10764
E02003461,4088,850,948,824,377,132,7219
E02003462,4565,1066,944,603,292,66,7536
E02003463,3743,957,947,647,232,40,6566
E02003464,4643,845,690,386,113,18,6695
E02003465,3317,878,910,571,327,77,6080
E02003466,5676,907,586,329,195,24,7717
E02003467,4284,735,680,418,227,98,6442
E02003468,5211,939,955,764,375,66,8310
E02003469,3255,791,842,477,165,22,5552
E02003470,4493,613,502,271,71,15,5965
E02003471,4362,820,744,455,145,40,6566
E02003472,7952,936,586,226,107,20,9827
E02003473,3474,765,624,422,123,40,5448
E02003474,6184,1128,880,500,157,33,8882
E02003475,18562,2100,1250,508,235,72,22727
E02003476,6724,1062,699,394,167,40,9086
E02003477,11520,1677,1010,752,362,77,15398
E02003478,4419,1018,700,421,162,52,6772
E02003479,5633,837,575,306,80,8,7439
E02003480,5609,1283,717,355,98,15,8077
E02003481,5862,844,730,395,150,33,8014
E02003482,3892,1081,827,557,301,66,6724
E02003483,8247,1704,663,286,126,20,11046
E02003484,4666,971,781,465,147,31,7061
E02003485,5018,1045,812,768,346,51,8040
E02003486,6819,1382,689,346,137,28,9401
E02003487,4241,919,874,803,351,70,7258
E02003488,4993,956,821,691,333,80,7874
E02003489,4317,1004,819,643,462,84,7329
E02003490,7079,900,623,437,173,58,9270
E02003491,4880,1227,739,630,294,84,7854
E02003492,9993,691,470,327,200,27,11708
E02003493,4586,1307,822,797,542,169,8223
E02003494,3902,1121,710,507,262,46,6548
E02003495,4529,1031,638,600,244,41,7083
E02003496,4548,1067,732,676,407,87,7517
E02003497,4417,1232,837,681,353,126,7646
E02003498,6666,1015,643,463,249,42,9078
E02003499,5820,935,556,441,238,54,8044
E02003500,5772,1327,639,323,127,39,8227
E02003501,5818,1301,740,539,293,106,8797
E02003502,5008,1187,660,510,279,41,7685
E02003503,5601,1359,869,659,367,95,8950
E02003504,6337,1120,653,396,199,64,8769
E02003505,8568,917,509,227,118,26,10365
E02003506,5296,915,530,292,137,42,7212
E02003507,5645,1517,1099,919,549,122,9851
E02003508,7893,969,514,304,132,25,9837
E02003509,6820,1108,638,477,238,73,9354
E02003510,6194,1167,650,492,313,132,8948
E02003511,5681,1265,719,506,251,76,8498
E02003512,7961,1012,539,284,107,25,9928
E02003513,3847,1100,677,534,322,115,6595
E02003514,7527,966,560,312,155,40,9560
E02003515,6399,1247,701,511,268,44,9170
E02003516,6784,1023,618,414,204,53,9096
E02003517,10340,1102,636,398,156,40,12672
E02003518,5221,1076,716,606,368,127,8114
E02003519,7758,1056,613,317,111,27,9882
E02003520,6975,1055,710,445,198,38,9421
E02003521,5612,1064,722,591,309,104,8402
E02003522,5013,1069,728,591,235,81,7717
E02003523,4963,1664,1360,1296,646,205,10134
E02003524,5346,1096,765,490,220,48,7965
E02003525,4447,853,580,368,177,24,6449
E02003526,3386,943,865,826,545,152,6717
E02003527,3965,856,637,571,252,47,6328
E02003529,5446,1131,748,594,303,82,8304
E02003530,4953,996,777,634,325,65,7750
E02003531,4520,1292,840,678,332,50,7712
E02003532,5127,1058,715,496,179,42,7617
E02003533,3987,732,479,326,178,30,5732
E02003534,6208,1225,791,526,207,42,8999
E02003535,7274,1235,703,424,182,46,9864
E02003536,5830,883,726,507,224,41,8211
E02003537,6563,1535,1021,762,389,65,10335
E02003538,8035,1162,658,467,191,49,10562
E02003539,13426,1209,878,591,262,56,16422
E02003540,5966,1280,937,924,458,128,9693
E02003541,10207,864,688,538,317,74,12688
E02003542,7291,858,575,420,209,49,9402
E02003543,6952,796,563,328,161,54,8854
E02003544,4517,869,479,329,147,24,6365
E02003545,5249,751,622,491,262,88,7463
E02003546,5348,1202,901,704,355,87,8597
E02003547,6311,964,815,827,491,119,9527
E02003548,4676,810,555,414,235,84,6774
E02006821,3942,975,614,641,337,66,6575
E02003549,6532,857,719,547,257,87,8999
E02003550,4893,946,922,709,217,50,7737
E02003551,5142,642,544,421,178,37,6964
E02003552,3681,765,742,570,175,52,5985
E02003553,6503,567,437,262,115,28,7912
E02003554,3937,688,619,553,309,130,6236
E02003555,5562,901,864,539,260,49,8175
E02003556,3606,839,574,493,284,38,5834
E02003557,5240,544,491,505,263,82,7125
E02003558,5082,737,538,424,219,52,7052
E02003559,4905,1067,836,590,337,99,7834
E02003560,5344,783,691,355,206,57,7436
E02003561,6735,666,516,385,212,69,8583
E02003562,5743,1063,753,579,271,82,8491
E02003563,5312,941,617,525,345,80,7820
E02003564,4833,997,756,637,358,89,7670
E02003565,6347,504,288,206,103,70,7518
E02003566,3640,794,701,569,301,84,6089
E02003567,5367,950,698,421,198,41,7675
E02003568,7090,771,589,319,176,52,8997
E02003569,5979,921,615,334,136,26,8011
E02003570,10441,990,488,212,82,4,12217
E02003571,9886,364,333,237,215,74,11109
E02003572,3809,856,631,501,260,43,6100
E02003573,4699,1003,774,618,369,73,7536
E02003574,4200,1081,856,793,365,42,7337
E02003575,4544,810,534,461,198,38,6585
E02003576,5627,1065,684,511,200,44,8131
E02003577,11911,1059,688,364,167,12,14201
E02003578,3745,933,634,484,220,50,6066
E02003579,6095,1130,836,584,349,98,9092
E02003580,4136,757,530,395,154,31,6003
E02003581,4562,1180,936,746,359,102,7885
E02003582,4338,1354,1172,1117,517,110,8608
E02003583,3866,1007,1062,1061,359,79,7434
E02003584,3505,1040,901,703,251,68,6468
E02003585,2757,1043,1149,1180,518,135,6782
E02003586,4172,1190,1027,973,407,99,7868
E02003587,5291,1276,1000,802,327,73,8769
E02003588,4874,1263,998,820,377,105,8437
E02003589,5175,1195,834,579,297,53,8133
E02003590,2703,1047,1275,1478,778,179,7460
E02003591,5412,1361,1147,1095,466,137,9618
E02003592,3480,1373,1737,1817,865,215,9487
E02003593,2092,864,1004,850,385,74,5269
E02003594,4694,1422,1419,1166,572,157,9430
E02003595,3158,1236,1445,1368,575,124,7906
E02003596,4024,1422,1476,1245,607,175,8949
E02003597,2476,912,1005,901,378,67,5739
E02003598,3171,1216,1314,1245,464,119,7529
E02004290,3002,942,842,663,279,48,5776
E02004291,4393,1101,817,614,267,56,7248
E02004292,3955,1201,969,1108,566,84,7883
E02004293,5874,1476,1026,825,438,119,9758
E02004294,4179,1497,1164,983,425,69,8317
E02004295,3879,1157,998,842,354,46,7276
E02004296,4778,1350,1087,782,326,41,8364
E02004297,4447,1309,1034,869,390,76,8125
E02004298,5316,1636,1385,1089,541,93,10060
E02004299,4824,1206,1226,851,342,89,8538
E02004300,4553,1100,951,858,349,56,7867
E02004301,6171,1255,1034,698,337,60,9555
E02004302,4715,1061,968,721,320,55,7840
E02004303,6447,1754,1330,1079,472,92,11174
E02004304,5551,1334,989,819,430,122,9245
E02004305,6386,1367,1063,795,348,34,9993
E02004306,2915,941,903,769,362,46,5936
E02004307,3687,1096,900,618,310,61,6672
E02004308,4354,1243,1181,1018,370,44,8210
E02004309,3759,856,716,605,339,67,6342
E02004310,4567,1147,1048,797,325,42,7926
E02004311,5057,1451,1257,970,376,71,9182
E02004312,3623,978,1053,1151,545,79,7429
E02004313,5784,726,569,514,249,34,7876
E02004314,13012,387,396,336,271,71,14473
E02004315,11106,1327,1126,778,346,92,14775
E02004316,3743,936,819,539,244,39,6320
E02004317,4090,1154,1059,822,365,85,7575
E02004318,3888,986,817,621,255,94,6661
E02004319,4601,1271,877,757,292,39,7837
E02004320,4998,1409,1192,801,473,85,8958
E02004321,5094,1256,1143,649,363,54,8559
E02004322,5215,1036,1053,814,343,56,8517
E02004323,4948,1225,887,607,338,61,8066
E02004324,3226,875,743,590,276,25,5735
E02004325,5342,1243,940,602,325,74,8526
E02004326,4257,986,743,566,275,29,6856
E02004327,3166,862,799,607,303,48,5785
E02004328,4549,988,740,614,331,52,7274
E02004329,3314,1031,972,708,315,53,6393
E02004330,2920,910,862,674,310,39,5715
E02004331,4250,1143,794,738,317,45,7287
E02004332,4290,1202,909,646,261,45,7353
E02004333,3455,1055,1167,871,312,50,6910
E02004334,4173,1180,901,675,258,53,7240
E02004335,4713,940,819,587,241,69,7369
E02004336,3434,1045,970,825,372,57,6703
E02004337,5973,1421,1269,874,397,69,10003
E02004338,4042,1178,864,682,300,40,7106
E02004339,3476,1050,905,980,367,69,6847
E02004340,5968,1536,1306,954,504,67,10335
E02004341,4639,1526,1212,931,286,77,8671
E02004342,3953,708,476,356,212,61,5766
E02004343,3106,837,671,532,323,35,5504
E02004344,3661,1123,998,791,475,82,7130
E02004345,6204,2172,1965,1580,680,127,12728
E02004346,2235,1015,871,682,291,48,5142
E02004347,3637,1078,1003,910,528,100,7256
E02004348,3547,1432,1327,1159,438,80,7983
E02004349,5702,1345,1123,798,410,64,9442
E02004350,5309,1418,1401,1064,398,102,9692
E02004351,4257,1110,953,682,298,61,7361
E02004352,4689,1163,945,727,349,65,7938
E02004353,3690,1268,953,848,485,96,7340
E02004354,5328,1356,1191,937,253,41,9106
E02004355,4400,1044,882,613,268,58,7265
E02003811,3195,1211,1003,911,390,55,6765
E02003812,3075,916,774,876,453,109,6203
E02003813,2956,1035,926,711,383,102,6113
E02003814,5085,1361,823,529,201,18,8017
E02003815,4353,967,781,678,362,67,7208
E02003816,3990,1043,859,819,345,107,7163
E02003817,3376,998,990,915,485,121,6885
E02003818,2478,911,857,768,296,70,5380
E02003819,2949,898,900,941,380,120,6188
E02003820,5947,1441,866,627,215,55,9151
E02003821,2659,854,766,736,336,65,5416
E02003822,5197,1891,1582,1518,611,87,10886
E02003823,3217,931,835,964,485,103,6535
E02003824,3110,832,714,690,270,64,5680
E02003825,3971,1203,693,358,100,22,6347
E02003826,5450,993,779,572,252,74,8120
E02003827,6663,1147,852,666,330,50,9708
E02003828,4524,817,644,554,265,76,6880
E02003829,3006,809,746,740,317,69,5687
E02003830,5793,979,689,442,227,56,8186
E02003831,5019,1716,1323,1082,480,87,9707
E02003832,4762,855,488,282,140,27,6554
E02003833,3668,933,631,561,240,61,6094
E02003834,4914,932,607,414,202,54,7123
E02003835,3555,1305,1142,1144,581,71,7798
E02003836,3518,935,914,933,512,196,7008
E02003837,8522,2486,1522,1147,458,109,14244
E02003838,3793,1043,914,810,363,71,6994
E02003839,3586,961,863,934,535,119,6998
E02003840,4669,1901,1835,1353,653,141,10552
E02003853,2957,1030,826,746,424,119,6102
E02003854,3220,901,911,826,359,78,6295
E02003855,2969,919,970,984,486,115,6443
E02003856,6466,1628,1156,983,504,132,10869
E02003857,4055,949,748,565,237,49,6603
E02003858,3762,1104,829,702,488,125,7010
E02003859,5828,2000,1654,1545,730,210,11967
E02003860,4121,1081,784,733,433,78,7230
E02003861,3604,931,693,697,375,80,6380
E02003862,2020,920,806,794,415,160,5115
E02003863,3549,980,846,799,433,108,6715
E02003864,4080,1323,1109,936,628,202,8278
E02003865,4327,1274,990,887,345,92,7915
E02003866,3019,1078,809,712,281,71,5970
E02003867,4339,1196,902,692,319,81,7529
E02003868,4972,1229,922,696,383,87,8289
E02003869,3782,1151,867,785,447,105,7137
E02003870,6547,1504,1003,759,406,99,10318
E02003871,3774,1056,835,684,339,73,6761
E02003872,4183,1793,1478,1351,698,92,9595
E02003873,3769,916,621,467,231,37,6041
E02003794,4708,1326,1139,1006,371,56,8606
E02003795,3116,783,759,670,347,102,5777
E02003796,4031,1000,843,781,518,92,7265
E02003797,6137,1381,1070,911,585,175,10259
E02003798,3839,938,596,495,165,40,6073
E02003799,4396,990,782,591,305,49,7113
E02003800,3517,1006,891,893,447,90,6844
E02003801,3968,983,814,633,364,77,6839
E02003802,5841,951,956,634,357,95,8834
E02003803,7563,791,687,533,278,80,9932
E02003804,4141,861,660,512,292,91,6557
E02003805,3165,981,877,814,366,93,6296
E02003806,4760,981,867,665,373,118,7764
E02003807,4070,1196,986,1072,561,122,8007
E02003808,4242,934,650,437,156,33,6452
E02003809,4004,1366,1060,993,482,106,8011
E02003810,4697,1399,1271,1121,477,129,9094
E02003841,3977,1161,1117,1064,522,110,7951
E02003842,2228,941,916,805,387,80,5357
E02003843,3310,965,795,581,330,44,6025
E02003844,3126,946,1005,926,411,62,6476
E02003845,6683,1271,837,487,313,81,9672
E02003846,4509,919,591,477,249,55,6800
E02003847,5065,1740,1225,970,416,50,9466
E02003848,3068,726,530,391,248,42,5005
E02003849,5244,1044,647,514,209,31,7689
E02003850,2708,783,718,573,233,35,5050
E02003851,2901,1016,679,614,291,50,5551
E02003852,3332,1034,902,710,357,64,6399
E02003874,4807,1364,1126,1174,551,149,9171
E02003875,2734,1152,1056,906,338,70,6256
E02003876,3181,760,718,599,195,42,5495
E02003877,4515,1572,1312,1177,573,142,9291
E02003878,4637,1395,1211,940,432,136,8751
E02003879,6094,1053,654,506,275,88,8670
E02003880,3364,940,863,713,265,82,6227
E02003881,3633,908,689,460,144,39,5873
E02003882,5636,1413,1095,727,379,42,9292
E02003883,6067,1813,1255,995,480,90,10700
E02003884,4192,1291,1199,1130,535,140,8487
E02003885,3179,937,840,658,291,83,5988
E02003886,4179,984,639,469,205,38,6514
E02003887,3888,1039,757,603,175,30,6492
E02003888,3820,957,668,510,262,52,6269
E02003889,3864,763,512,506,219,36,5900
E02003890,3986,948,728,571,216,39,6488
E02003891,2921,935,891,862,365,69,6043
E02006008,5378,1416,1096,976,440,89,9395
E02006009,4006,921,720,732,455,136,6970
E02006010,5945,1912,1766,1456,588,129,11796
E02006011,3018,791,763,834,437,120,5963
E02006012,2886,1065,998,920,410,79,6358
E02006013,3517,1305,1153,1187,480,110,7752
E02006014,4516,1566,1581,1404,507,110,9684
E02006015,5804,1611,1286,1109,535,154,10499
E02006016,3965,1401,1240,1155,406,69,8236
E02006017,4203,1323,1139,940,464,78,8147
E02006018,7046,1721,1445,1347,656,112,12327
E02006019,3464,852,779,716,463,69,6343
E02006020,4719,1202,923,597,259,69,7769
E02006021,4365,1612,1260,902,375,64,8578
E02006022,3619,946,816,605,283,69,6338
E02006023,5409,1558,1371,1083,507,105,10033
E02006024,6097,1472,1155,861,472,107,10164
E02006025,5559,1445,1098,1103,596,154,9955
E02006026,3766,1153,1045,821,307,57,7149
E02006027,2544,915,860,744,357,71,5491
E02006028,4817,1573,1255,1139,531,117,9432
E02006029,5087,1110,843,671,358,52,8121
E02006030,5367,1158,817,576,263,68,8249
E02006031,5188,1225,861,650,342,95,8361
E02006032,5522,1295,1002,829,315,47,9010
E02006033,4819,1267,1057,974,500,165,8782
E02006034,6063,1515,1240,932,432,120,10302
E02006035,2545,787,815,913,458,84,5602
E02006036,3512,1015,830,632,349,89,6427
E02006037,5888,1527,1270,992,486,171,10334
E02006038,4259,1237,1176,1015,451,75,8213
E02006039,4179,1237,1201,1011,450,111,8189
E02006040,4059,1370,1099,993,381,54,7956
E02006041,2711,1070,978,780,327,79,5945
E02006042,2246,938,1052,1027,582,144,5989
E02006043,3214,1153,1114,903,379,67,6830
E02006044,2670,1060,1152,976,406,74,6338
E02006045,5262,1577,1499,1498,924,228,10988
E02006046,4315,1570,1343,1290,521,82,9121
E02003892,2707,1105,1209,1013,335,87,6456
E02003893,2961,1170,1186,910,310,68,6605
E02003894,4409,1271,1187,992,417,72,8348
E02003895,4987,1299,1180,919,400,66,8851
E02003896,3152,862,753,714,323,51,5855
E02003897,2805,945,851,733,225,19,5578
E02003898,3031,1166,1120,1012,343,53,6725
E02003899,2822,789,731,775,303,58,5478
E02003900,3941,1040,933,806,333,51,7104
E02003901,3418,1312,1384,1156,472,111,7853
E02003902,2889,745,748,559,237,36,5214
E02003903,2986,1066,1050,859,325,39,6325
E02003904,1886,887,949,824,365,84,4995
E02003905,3978,1106,898,632,222,31,6867
E02003906,3117,832,837,765,321,65,5937
E02003907,4732,1116,1114,936,394,78,8370
E02003908,4999,1152,945,883,443,90,8512
E02003909,6214,1459,1236,995,480,107,10491
E02003910,3708,903,725,665,377,82,6460
E02003911,4415,1366,1223,1364,582,90,9040
E02003912,3615,1339,1257,1219,467,112,8009
E02003913,2770,892,1044,974,423,71,6174
E02003914,5750,907,745,629,270,38,8339
E02003915,5073,932,797,676,315,58,7851
E02003916,4480,640,734,683,381,82,7000
E02003917,4652,1127,1109,851,390,66,8195
E02003918,3585,1106,1093,882,380,75,7121
E02003919,4361,1066,848,708,383,55,7421
E02003920,4685,1157,894,837,423,85,8081
E02003921,3199,946,826,751,309,64,6095
E02003922,5271,1265,951,776,349,61,8673
E02003923,5471,1009,934,767,328,62,8571
E02003924,3545,1032,950,912,444,87,6970
E02003925,4324,1069,900,702,298,57,7350
E02003926,4547,1417,1209,888,336,62,8459
E02003927,6743,1371,1418,1329,516,117,11494
E02003928,7428,1690,1292,1137,536,78,12161
E02003929,3171,1127,1108,1020,423,82,6931
E02003930,4817,1342,1533,1312,516,110,9630
E02003931,5464,1455,1555,1386,655,152,10667
E02003932,3672,1174,1311,896,407,98,7558
E02003933,3225,1155,1279,1054,394,85,7192
E02003934,3663,1128,1082,936,361,82,7252
E02003935,6806,1487,1139,901,471,114,10918
E02003936,3646,1505,1453,1279,488,128,8499
E02003937,2556,825,848,771,441,189,5630
E02003938,3865,964,940,884,383,80,7116
E02003939,3590,981,900,934,559,136,7100
E02003940,2684,1137,1072,884,381,84,6242
E02003941,5150,1160,898,780,367,87,8442
E02003942,4946,1011,895,711,359,76,7998
E02003943,3294,1037,1161,928,423,113,6956
E02003944,5417,1435,1298,1328,553,113,10144
E02003945,2577,1000,995,979,429,124,6104
E02003946,4856,1549,1368,1246,478,125,9622
E02003947,2967,1114,1119,988,349,109,6646
E02003948,4313,1294,1023,1038,506,110,8284
E02003949,3275,1077,963,804,420,112,6651
E02003950,2645,878,1013,670,293,104,5603
E02003951,2527,920,976,971,438,97,5929
E02003952,5263,1172,1041,856,345,109,8786
E02003953,6575,1598,1385,1222,529,123,11432
E02003954,4311,1005,901,663,392,131,7403
E02003955,5773,1411,1201,994,478,109,9966
E02003956,4637,1132,1007,721,330,66,7893
E02003957,5878,1778,1502,1237,526,98,11019
E02003958,4802,1308,1122,798,330,56,8416
E02003959,3977,1034,861,786,354,98,7110
E02003960,2518,984,980,963,482,130,6057
E02003961,5153,1450,1371,1220,530,139,9863
E02003962,4093,1089,872,736,393,130,7313
E02003963,5656,1379,1213,1080,652,168,10148
E02003964,3279,1251,1319,1402,645,134,8030
E02006781,1159,325,298,275,121,46,2224
E02006634,4306,1498,1273,999,446,111,8633
E02006635,4594,1263,997,939,556,184,8533
E02006636,3379,1203,1058,853,414,80,6987
E02006637,6550,1664,1160,1025,510,81,10990
E02006638,2952,952,874,855,518,105,6256
E02006639,3994,1580,1263,1137,424,68,8466
E02006640,3846,1267,1097,783,352,44,7389
E02006641,4274,1410,1106,885,397,95,8167
E02006642,2851,1071,836,632,225,38,5653
E02006643,15015,1318,926,557,207,62,18085
E02006644,3241,1110,998,801,308,67,6525
E02006645,4615,1166,925,736,315,77,7834
E02006646,4601,1213,800,626,390,109,7739
E02006647,2830,1044,948,803,271,62,5958
E02006648,3286,993,746,659,327,98,6109
E02006649,4217,1228,922,703,354,97,7521
E02006650,7963,1783,1389,1246,524,79,12984
E02006651,3961,1352,1015,812,284,51,7475
E02006652,5910,1613,953,689,359,79,9603
E02006653,5691,1573,1068,916,341,73,9662
E02006654,5500,1292,932,889,620,162,9395
E02006655,3535,1409,1087,867,423,133,7454
E02006656,4083,1294,772,433,197,30,6809
E02006657,7095,1538,1030,790,329,86,10868
E02006658,3988,1277,994,832,386,63,7540
E02006659,4790,1057,870,784,338,95,7934
E02006660,7656,1940,1608,1414,690,144,13452
E02006661,8816,804,597,384,164,40,10805
E02006662,3671,854,813,571,238,41,6188
E02006663,7857,1740,1255,844,514,144,12354
E02006664,3221,1043,930,796,334,79,6403
E02006665,2937,1091,1057,1068,454,128,6735
E02006666,3997,999,680,586,334,84,6680
E02006667,4609,933,658,397,182,34,6813
E02006668,2929,953,760,787,327,115,5871
E02006669,5039,1660,1430,1341,688,143,10301
E02006670,4080,946,745,586,285,100,6742
E02006671,3545,878,687,581,331,86,6108
E02006672,5623,1132,854,820,489,154,9072
E02006673,2404,590,728,689,448,129,4988
E02006674,3556,814,683,510,329,70,5962
E02006675,3789,1439,1184,985,465,85,7947
E02006676,2882,1049,1012,849,431,90,6313
E02006677,3813,1303,1174,1040,554,146,8030
E02006678,4584,1072,789,798,318,39,7600
E02006679,6429,1744,1408,1177,560,96,11414
E02006680,3927,1147,905,787,509,131,7406
E02006681,2717,912,871,799,414,99,5812
E02006682,4923,1416,1466,1301,710,194,10010
E02006683,5085,1305,941,728,297,57,8413
E02006684,4402,895,658,485,210,23,6673
E02006685,6644,1139,1008,857,457,111,10216
E02006686,3087,818,645,539,308,140,5537
E02006687,4894,1195,811,557,208,21,7686
E02006688,3416,852,557,525,237,37,5624
E02006689,3632,999,964,893,351,46,6885
E02006690,3003,1112,1015,950,390,66,6536
E02006691,9198,2061,1374,1235,593,153,14614
E02006692,3506,641,609,502,314,89,5661
E02006693,3215,917,805,667,308,50,5962
E02006694,3135,928,799,803,425,111,6201
E02006695,2833,1130,975,952,450,101,6441
E02003616,2670,1011,781,691,291,66,5510
E02003617,4340,1558,1219,1038,526,108,8789
E02003618,5025,1308,995,865,469,71,8733
E02003619,6907,1778,1432,1136,457,105,11815
E02003620,4188,1202,1039,946,561,99,8035
E02003621,3844,1161,1069,1069,527,100,7770
E02003622,5820,1199,893,665,388,85,9050
E02003623,6521,1491,1220,942,449,87,10710
E02003624,3488,767,547,494,333,133,5762
E02003625,5585,1103,846,598,442,185,8759
E02003626,3354,806,595,396,182,33,5366
E02003627,7100,1358,891,581,333,124,10387
E02003628,7312,958,630,310,232,41,9483
E02003629,7092,1242,862,525,373,97,10191
E02003630,8233,1299,769,428,203,57,10989
E02003631,3261,809,684,459,205,42,5460
E02003632,3703,861,656,433,216,54,5923
E02003633,6502,1285,926,646,283,57,9699
E02003634,8859,1671,1253,934,351,84,13152
E02003635,4956,1062,695,604,313,79,7709
E02003599,3938,826,582,384,165,34,5929
E02003600,3996,1006,784,639,210,58,6693
E02003601,4395,1176,1072,747,298,57,7745
E02003602,3100,1030,919,741,336,59,6185
E02003603,7137,1419,1075,795,376,112,10914
E02003604,7425,1262,930,724,340,78,10759
E02003605,6157,1243,874,852,309,53,9488
E02003606,4291,1374,1073,897,432,57,8124
E02003607,6874,1552,1085,835,348,82,10776
E02003608,7338,1899,1392,983,445,87,12144
E02003609,7617,1700,1081,802,353,69,11622
E02003610,5312,1320,831,700,451,46,8660
E02003611,5770,1429,1073,826,389,106,9593
E02003612,8283,1637,1152,902,371,68,12413
E02003613,3625,863,588,483,260,69,5888
E02003614,4856,1273,954,571,242,35,7931
E02003615,5777,1605,1228,961,408,73,10052
E02003636,4287,1266,764,682,332,51,7382
E02003637,5526,1722,1289,1032,501,62,10132
E02003638,4394,1132,1009,774,347,62,7718
E02003639,6181,1298,936,721,389,129,9654
E02003640,3637,821,739,670,260,87,6214
E02003641,3241,844,692,606,194,24,5601
E02003642,7068,1224,829,423,189,17,9750
E02003643,9942,1401,981,686,331,45,13386
E02003644,6466,1363,1011,601,328,78,9847
E02003645,4244,1103,705,601,388,63,7104
E02003646,6983,1308,976,753,326,67,10413
E02003647,6693,1279,876,751,492,144,10235
E02003648,3755,765,542,362,254,59,5737
E02003649,3799,1086,782,840,330,38,6875
E02003650,3382,1149,1027,908,406,82,6954
E02003651,3679,963,894,841,327,26,6730
E02005702,3007,1069,1035,919,453,123,6606
E02005703,3399,1084,1019,773,377,100,6752
E02005704,5910,2160,2082,1616,762,130,12660
E02005705,3102,1321,1508,1123,467,111,7632
E02005706,5232,1362,1279,1005,546,126,9550
E02005707,3045,1199,1201,1192,458,79,7174
E02005708,4146,1822,2018,1623,717,116,10442
E02005709,4577,911,709,488,251,73,7009
E02005710,5648,1323,1135,835,392,98,9431
E02005711,4756,1124,997,849,336,53,8115
E02005712,5613,1163,883,637,261,19,8576
E02005713,3200,1040,1064,776,285,39,6404
E02005714,2874,886,803,484,76,19,5142
E02005715,5234,1110,1066,819,438,101,8768
E02005716,5175,1260,1249,844,299,69,8896
E02005717,3628,1161,1194,1002,506,92,7583
E02005718,2918,894,1070,1109,364,61,6416
E02005719,4931,1254,1095,903,321,47,8551
E02005720,6536,1847,1777,1328,472,114,12074
E02005721,2947,921,786,513,304,55,5526
E02005722,4106,1471,1360,950,339,63,8289
E02005723,2949,892,976,753,493,114,6177
E02005724,3226,1040,953,915,450,84,6668
E02005725,3197,1019,999,890,587,187,6879
E02005726,3838,1219,1101,1003,551,122,7834
E02005727,2875,1175,1092,804,338,49,6333
E02005728,3326,1151,1118,971,396,68,7030
E02005729,2839,953,887,679,292,47,5697
E02005730,6335,2049,1900,1605,866,271,13026
E02005731,6329,1779,1310,1096,441,92,11047
E02005732,4059,1440,1505,1290,726,141,9161
E02005733,3975,1447,1474,1065,408,111,8480
E02005734,3227,932,903,713,311,47,6133
E02005735,5111,1049,772,554,234,79,7799
E02005736,5131,1105,972,742,249,45,8244
E02005737,3928,1178,1046,742,319,76,7289
E02005738,2607,834,704,553,204,21,4923
E02005739,4826,1447,1242,1069,523,92,9199
E02005740,6132,1508,1264,949,420,95,10368
E02005741,4473,1472,1168,868,475,95,8551
E02003172,3416,948,805,696,361,95,6321
E02003173,3230,923,899,795,481,109,6437
E02003174,4304,1184,989,904,492,106,7979
E02003175,5755,1268,940,737,329,106,9135
E02003176,4772,1031,740,530,266,45,7384
E02003177,5093,1190,833,562,357,61,8096
E02003178,5230,1108,876,735,387,78,8414
E02003179,3814,919,696,694,344,94,6561
E02003180,7201,991,601,494,208,55,9550
E02003181,5595,1170,829,653,323,97,8667
E02003182,3790,963,775,619,296,87,6530
E02003183,4163,936,734,685,339,99,6956
E02003184,6019,826,534,342,207,79,8007
E02003185,4658,1156,775,589,301,64,7543
E02003186,6793,1156,658,400,213,10,9230
E02003187,6209,1281,932,623,323,58,9426
E02003188,9755,915,918,750,494,158,12990
E02003189,4753,1246,1035,846,567,207,8654
E02003190,7393,1438,949,499,274,94,10647
E02003191,3771,1134,1238,1211,673,243,8270
E02003192,9501,1047,910,816,426,163,12863
E02003194,2986,810,903,939,423,105,6166
E02003195,3305,760,669,461,239,61,5495
E02003196,4472,1751,1462,1312,938,235,10170
E02003197,3912,1040,864,614,274,25,6729
E02003198,4692,1053,718,654,227,45,7389
E02003199,5111,1375,1127,935,503,101,9152
E02003200,6259,1355,1088,1003,436,94,10235
E02003201,7051,1467,1093,845,379,73,10908
E02003202,3878,815,708,561,269,44,6275
E02003203,4822,1083,786,567,234,58,7550
E02003204,5244,1300,992,883,511,139,9069
E02003205,4594,1269,1030,883,464,88,8328
E02003206,6149,1484,1006,885,432,87,10043
E02003207,4619,939,620,640,279,51,7148
E02003208,7257,1462,1241,1051,748,164,11923
E02003209,3607,999,856,648,298,58,6466
E02003210,5088,1340,1140,1128,718,167,9581
E02003211,3508,1055,1315,1608,1109,361,8956
E02004236,2863,876,891,864,449,80,6023
E02004237,4398,1207,939,986,564,166,8260
E02004238,2731,941,1092,1484,975,223,7446
E02004239,2628,857,893,1070,519,116,6083
E02004240,3946,965,676,503,237,42,6369
E02004241,5412,1198,1077,1127,720,149,9683
E02004242,2269,940,1115,1251,668,173,6416
E02006883,3444,642,553,564,454,222,5879
E02006885,4729,956,807,775,493,169,7929
E02004243,3225,1149,1011,797,294,47,6523
E02004244,3821,1052,951,976,515,111,7426
E02004245,4074,1083,973,960,488,131,7709
E02004246,2568,1127,1325,1508,662,164,7354
E02004247,2865,1127,995,779,306,83,6155
E02004248,2804,1024,1199,1506,889,201,7623
E02004249,2820,875,829,805,339,33,5701
E02004250,3448,950,1176,1330,816,240,7960
E02004251,3124,966,893,934,514,111,6542
E02004252,3989,1022,944,918,619,181,7673
E02004253,3953,1356,1452,1608,969,303,9641
E02004254,5566,1515,1365,1188,503,82,10219
E02004255,3838,1104,984,976,565,173,7640
E02004256,4563,1441,1432,1107,489,138,9170
E02004257,5143,1165,1054,917,502,154,8935
E02004258,4570,1535,1608,1541,765,191,10210
E02004259,3459,1121,1141,1014,434,87,7256
E02004260,5414,1161,1080,969,371,66,9061
E02004261,5868,1505,1257,1110,577,153,10470
E02004262,3629,1462,1344,1104,372,65,7976
E02004263,2971,943,893,720,334,59,5920
E02004264,4729,1291,1119,1005,476,81,8701
E02004265,4205,1310,1342,1186,620,124,8787
E02004266,5321,1147,1025,939,366,68,8866
E02004267,1955,846,961,814,354,77,5007
E02004268,4172,1501,1567,1621,754,202,9817
E02004269,5058,1149,1156,1396,879,256,9894
E02004270,3157,1321,1345,1213,522,121,7679
E02004271,4106,1553,1633,1568,682,146,9688
E02004272,5581,2052,1808,1620,689,149,11899
E02004273,2631,1224,1320,1244,635,169,7223
E02004274,3010,968,1061,930,456,124,6549
E02004275,3015,1142,1493,1259,545,84,7538
E02004276,2205,798,1004,948,480,117,5552
E02004277,6518,1762,1406,1431,1042,306,12465
E02004278,4695,1338,1218,1063,541,118,8973
E02004279,3640,1298,1387,1130,486,96,8037
E02004280,3958,1332,1277,1070,518,75,8230
E02004281,4377,1167,946,686,275,33,7484
E02004282,3397,1206,1592,1577,809,205,8786
E02004283,4417,1301,1252,1130,536,115,8751
E02004284,5051,1460,1419,1128,579,147,9784
E02004285,4046,1165,960,838,435,101,7545
E02004286,2744,842,707,555,273,86,5207
E02004287,2876,865,788,733,248,61,5571
E02004288,3540,1006,756,504,196,41,6043
E02004289,3789,1110,1108,901,299,61,7268
E02003652,7483,1503,1085,746,334,81,11232
E02003653,4304,910,698,602,305,56,6875
E02003654,3017,998,864,638,254,39,5810
E02003655,5825,1656,1263,993,339,61,10137
E02003656,3316,1009,850,711,362,94,6342
E02003657,3691,1144,966,685,288,54,6828
E02003658,5146,1357,1110,833,352,116,8914
E02003659,6430,1522,988,762,262,81,10045
E02003660,5824,1798,1276,972,404,74,10348
E02003661,3462,1044,768,516,244,51,6085
E02003662,4497,999,606,394,174,35,6705
E02003663,10288,1128,661,367,146,46,12636
E02003664,6566,992,546,367,242,95,8808
E02003665,4103,913,507,413,215,33,6184
E02003666,6103,958,577,393,284,75,8390
E02003667,7154,1249,756,466,172,37,9834
E02003668,5144,1271,980,899,601,112,9007
E02003669,5938,904,581,371,131,37,7962
E02003670,6731,1276,954,657,277,91,9986
E02003671,4424,831,584,286,85,13,6223
E02003672,5897,1784,1351,1130,554,105,10821
E02003673,4805,1258,1136,1109,537,127,8972
E02003674,2900,911,724,662,242,48,5487
E02003675,5999,1274,889,801,466,159,9588
E02003676,3863,1480,1132,926,459,72,7932
E02003677,6524,1420,986,772,413,77,10192
E02003678,3533,821,628,458,266,100,5806
E02003679,4580,954,593,542,325,72,7066
E02003680,5042,1526,1191,1123,609,113,9604
E02003681,6344,1459,1049,947,613,222,10634
E02003682,4596,1118,827,714,304,53,7612
E02003683,4339,1052,759,617,396,88,7251
E02003685,4326,1327,946,830,448,108,7985
E02003686,3870,1164,882,770,555,132,7373
E02003687,3288,920,661,490,367,100,5826
E02006823,4507,1338,1181,994,600,145,8765
E02003688,7650,1812,1233,1066,789,202,12752
E02003689,5112,1414,1033,860,536,167,9122
E02003690,3691,1046,781,694,526,149,6887
E02003691,3815,1108,770,696,383,136,6908
E02003692,5002,1422,1151,855,481,76,8987
E02003693,3430,1099,926,747,421,96,6719
E02003694,4888,1199,903,595,317,68,7970
E02003695,6685,1741,1249,863,452,105,11095
E02003696,3866,1154,1038,1042,654,197,7951
E02003697,2871,961,811,712,324,90,5769
E02003698,4015,1383,1023,1085,499,76,8081
E02003699,3066,885,729,570,268,65,5583
E02003701,7513,1529,962,911,449,99,11463
E02003702,4336,1419,984,867,351,67,8024
E02003703,5821,1144,713,457,217,42,8394
E02003704,3183,896,732,559,227,47,5644
E02003705,5104,752,542,313,163,25,6899
E02003706,4805,817,567,426,215,57,6887
E02003707,5127,832,481,302,185,28,6955
E02003708,7719,920,658,259,175,27,9758
E02003709,4063,675,456,273,176,24,5667
E02003710,8789,1208,846,566,304,82,11795
E02003711,6826,1150,779,582,264,70,9671
E02003712,4444,1120,875,776,499,105,7819
E02003713,3088,855,711,630,448,70,5802
E02003714,4043,924,732,541,240,40,6520
E02003715,3362,1011,831,804,325,48,6381
E02003716,2723,872,736,660,390,90,5471
E02003717,4797,1275,993,989,622,154,8830
E02003718,3307,807,583,515,273,114,5599
E02006824,5113,1404,1062,1097,520,109,9305
E02003719,5488,1060,776,474,352,111,8261
E02003720,5733,995,815,577,317,104,8541
E02003721,5949,1035,806,520,381,123,8814
E02003722,5032,1001,832,650,305,92,7912
E02003723,8095,577,506,392,240,54,9864
E02003724,6348,1100,765,435,238,69,8955
E02003725,12351,920,765,624,364,115,15139
E02003726,6513,786,616,350,141,36,8442
E02003727,6420,923,540,334,177,53,8447
E02003728,6341,979,743,478,295,82,8918
E02003729,5129,1020,804,665,327,95,8040
E02003730,10901,1423,794,699,349,119,14285
E02003731,6000,1157,862,599,437,125,9180
E02003732,6328,1325,978,743,396,118,9888
E02003733,4789,1342,1063,925,345,64,8528
E02003734,7860,1547,1209,1051,512,164,12343
E02003735,5777,1210,931,857,436,92,9303
E02003736,5618,1589,1322,1152,439,76,10196
E02003737,9044,1901,1408,1013,486,120,13972
E02003738,3548,985,756,663,273,55,6280
E02003739,3523,1005,773,685,331,100,6417
E02003740,3341,973,830,670,387,110,6311
E02006825,3613,991,832,768,340,58,6602
E02003742,3145,1041,1042,964,394,78,6664
E02003743,7500,1373,1041,867,461,134,11376
E02003744,8614,1930,1648,1266,716,181,14355
E02003745,5519,1578,1438,1227,459,93,10314
E02003746,4678,1077,802,744,369,86,7756
E02003747,6670,1618,1484,1299,650,161,11882
E02003748,4222,1053,1069,920,463,92,7819
E02003749,3192,1029,842,653,242,66,6024
E02003750,3796,1040,972,962,545,166,7481
E02003751,3653,1145,971,812,364,82,7027
E02003752,6562,1609,1281,1033,539,128,11152
E02003753,6997,1572,1229,1035,391,90,11314
E02003754,2913,952,881,604,293,40,5683
E02003755,4558,1351,1011,818,356,52,8146
E02003756,3915,1153,838,723,275,56,6960
E02003757,3474,1012,897,685,339,131,6538
E02003758,5691,1375,1204,893,353,90,9606
E02003759,3041,1040,856,698,214,59,5908
E02003760,6890,1067,646,414,231,29,9277
E02003761,3216,896,731,680,347,85,5955
E02003762,5689,1378,1039,949,415,98,9568
E02003763,5967,1345,1176,844,313,51,9696
E02003764,7423,1396,847,507,347,93,10613
E02003765,4243,945,763,774,466,131,7322
E02003766,4536,1023,775,639,252,54,7279
E02003767,3310,1214,880,743,310,40,6497
E02003768,4979,1474,1283,1308,577,117,9738
E02003769,3762,1240,1100,974,337,103,7516
E02003770,6838,1392,983,847,317,63,10440
E02003771,3763,990,665,628,348,98,6492
E02003772,3532,1064,916,837,340,60,6749
E02003773,7009,1551,993,848,390,52,10843
E02003774,3366,844,613,616,305,79,5823
E02003775,4010,1079,817,667,255,58,6886
E02003776,3678,1008,786,659,362,100,6593
E02003777,5546,1007,825,621,264,42,8305
E02003778,4081,818,612,512,252,73,6348
E02003779,2882,776,675,491,166,37,5027
E02003780,8095,1427,1040,818,533,178,12091
E02003781,4005,980,689,460,257,46,6437
E02003783,4456,976,821,738,440,159,7590
E02003784,4859,1405,1011,885,398,56,8614
E02003785,5711,1198,921,782,463,98,9173
E02003786,3668,909,755,679,421,156,6588
E02003787,3710,1197,1038,887,405,61,7298
E02003788,4231,1158,838,808,352,77,7464
E02003789,4113,987,854,794,407,78,7233
E02003790,4967,1522,1247,1022,532,129,9419
E02003791,4533,1334,962,798,321,76,8024
E02003792,5323,1455,1222,1101,440,123,9664
E02003793,3869,1235,821,760,275,39,6999
E02006873,7838,944,313,217,137,20,9469
E02006874,6488,1444,917,665,287,63,9864
E02003965,5549,1699,1600,1392,671,176,11087
E02003966,3172,1241,1144,973,394,82,7006
E02003967,4366,1343,1205,951,454,59,8378
E02003968,4846,1387,1195,1085,498,100,9111
E02003969,4060,944,764,611,286,49,6714
E02003970,4063,1400,1180,933,422,121,8119
E02003971,3733,1299,1232,1012,474,117,7867
E02003972,5034,1469,1067,967,460,82,9079
E02003973,5379,1225,1034,693,313,76,8720
E02003974,4408,1120,961,837,405,74,7805
E02003975,3821,1084,953,794,416,98,7166
E02003976,3030,1126,996,919,504,134,6709
E02003977,3436,1045,817,618,272,41,6229
E02003978,2983,915,664,669,278,47,5556
E02003979,3349,1235,1080,1123,629,114,7530
E02003980,4028,915,770,548,196,30,6487
E02003981,3917,1020,723,597,257,78,6592
E02003982,4260,1178,953,865,315,58,7629
E02003983,4666,1103,799,614,278,41,7501
E02003984,4218,886,673,498,249,69,6593
E02003985,3750,930,884,795,326,56,6741
E02003986,3481,939,764,709,262,36,6191
E02003987,2867,1019,950,701,301,75,5913
E02003988,3201,1152,980,842,387,89,6651
E02003989,3714,1038,970,874,411,85,7092
E02003990,5561,1563,1374,1114,627,143,10382
E02003991,3684,1198,1189,944,403,89,7507
E02003992,4987,1254,948,594,335,88,8206
E02003993,4033,1468,1495,1174,519,102,8791
E02003994,4374,1002,751,590,408,111,7236
E02003995,6078,1368,1012,870,412,88,9828
E02003996,6319,1322,951,575,278,58,9503
E02003997,6264,1201,972,675,316,91,9519
E02003998,4262,907,725,602,274,47,6817
E02003999,6161,1605,1485,1236,618,128,11233
E02004000,2784,831,710,523,289,62,5199
E02004001,2820,862,720,551,279,62,5294
E02004002,5535,1574,1240,1006,526,80,9961
E02004003,6276,1977,1630,1159,491,87,11620
E02004004,6119,1342,1151,758,373,90,9833
E02004005,4323,1182,1031,835,352,45,7768
E02004006,4041,1511,1396,1106,539,96,8689
E02004007,4966,1579,1435,1250,489,100,9819
E02004008,2859,1162,1130,790,294,72,6307
E02004009,2967,1146,962,718,336,44,6173
E02004010,4515,1055,780,625,379,161,7515
E02004011,5031,1551,1471,1335,695,181,10264
E02004012,2422,992,932,748,342,71,5507
E02004013,4618,1676,1558,1298,581,118,9849
E02004014,3474,1324,1262,1017,464,97,7638
E02004015,3090,955,903,829,497,141,6415
E02004016,4148,1365,1094,1050,484,119,8260
E02004017,4878,1351,1118,882,494,98,8821
E02004018,5005,1258,991,736,344,113,8447
E02004019,3701,1317,1188,1107,499,94,7906
E02004020,4547,1375,1133,980,541,181,8757
E02004021,2196,945,931,852,338,80,5342
E02004022,2283,1001,1049,823,304,45,5505
E02004023,2842,958,1005,846,448,98,6197
E02004024,3301,1201,1199,1065,545,101,7412
E02004025,3548,1216,1262,1265,552,169,8012
E02004026,4473,1260,1010,839,445,108,8135
E02004027,3025,1217,1425,1481,794,213,8155
E02004028,3485,1311,1167,1160,531,70,7724
E02004029,4146,984,923,598,275,46,6972
E02004030,2680,1010,1007,828,341,54,5920
E02004031,5143,1052,783,601,240,80,7899
E02004032,4419,1289,1173,1152,419,102,8554
E02004033,5120,1468,1093,823,394,136,9034
E02004034,3477,1136,1065,1142,420,77,7317
E02004035,3036,1134,1076,943,381,73,6643
E02004036,6116,1548,1233,1060,404,65,10426
E02004037,4601,1355,960,824,339,64,8143
E02004038,4309,1274,955,805,402,126,7871
E02004039,4510,1353,1010,802,351,91,8117
E02004040,5881,1478,1071,787,353,63,9633
E02004041,4491,1055,901,692,242,50,7431
E02004043,3989,1118,1028,847,339,90,7411
E02004044,4678,1366,1037,966,497,142,8686
E02006827,4978,1170,860,722,298,62,8090
E02004045,5412,1523,1282,1054,446,77,9794
E02004046,3332,1007,887,691,311,79,6307
E02004047,3987,793,692,559,229,32,6292
E02004048,4289,1044,766,566,231,37,6933
E02004049,3905,1274,1149,927,400,113,7768
E02004050,4931,1155,774,647,326,53,7886
E02004051,6187,1520,1120,903,346,69,10145
E02004052,4834,1370,1041,815,370,71,8501
E02004053,4875,1150,865,684,261,39,7874
E02004054,5252,1497,1037,844,371,61,9062
E02004055,4004,1084,871,764,384,78,7185
E02004056,5152,1035,857,579,263,38,7924
E02004057,5173,1110,833,520,217,25,7878
E02004058,4616,1141,857,746,323,79,7762
E02004059,3649,1196,975,824,436,80,7160
E02004060,4357,1057,962,850,347,55,7628
E02004061,4332,1255,863,699,380,91,7620
E02004062,4118,1256,1188,877,320,81,7840
E02004063,4010,1282,1088,961,491,123,7955
E02004064,6647,1287,877,497,278,77,9663
E02004065,3708,1264,1307,1160,557,133,8129
E02004066,6639,1740,1336,1187,562,142,11606
E02004067,3867,974,809,593,240,67,6550
E02004068,3314,1422,1134,944,434,114,7362
E02004069,2689,1075,1046,995,441,80,6326
E02004070,2598,993,1067,930,479,126,6193
E02004071,2468,812,738,650,288,73,5029
E02004072,4600,1466,1329,1221,552,137,9305
E02004073,4456,1515,1447,1143,524,108,9193
E02004074,3020,1039,920,758,332,49,6118
E02004075,3206,1438,1167,954,381,69,7215
E02004076,4393,1094,804,713,345,94,7443
E02004077,4138,1504,1079,928,424,68,8141
E02004078,4470,963,759,626,299,54,7171
E02004080,6133,1360,954,774,424,117,9762
E02004081,3052,936,878,684,339,71,5960
E02004082,2939,1073,903,764,403,131,6213
E02004083,5120,1205,804,708,272,57,8166
E02004084,3631,840,656,610,348,97,6182
E02004085,5173,1351,995,913,527,139,9098
E02004086,3915,1131,913,860,437,92,7348
E02004087,4870,1238,805,604,317,65,7899
E02004088,4202,1318,998,841,351,83,7793
E02004089,4920,1020,598,427,225,53,7243
E02004090,3283,1014,730,717,392,91,6227
E02004091,5390,1549,1046,915,420,71,9391
E02004092,6003,1390,1042,987,440,65,9927
E02006828,4272,1132,777,561,209,40,6991
E02004093,3743,1072,783,506,216,38,6358
E02004094,4641,1075,757,631,219,43,7366
E02004095,5986,1704,1210,896,328,65,10189
E02004096,4998,1600,1399,1105,466,89,9657
E02004097,4210,1341,1093,875,286,55,7860
E02004098,4020,1117,962,804,303,60,7266
E02004100,4075,1357,1178,849,380,94,7933
E02004102,4598,1336,1114,794,496,120,8458
E02004103,4565,1015,712,552,263,51,7158
E02004104,3978,1260,974,791,326,48,7377
E02006872,6807,2089,1843,1511,664,130,13044
E02004105,5368,1511,1319,881,356,65,9500
E02004106,3056,1048,1051,1063,476,53,6747
E02004108,4073,1213,806,889,479,94,7554
E02004109,3004,1013,1004,1090,515,87,6713
E02004110,3940,978,986,1015,421,41,7381
E02004111,2924,903,827,699,318,44,5715
E02004112,2661,1079,1061,1099,492,77,6469
E02004113,6249,1332,1110,800,376,83,9950
E02004114,3592,1190,1240,1170,469,90,7751
E02004115,4981,1495,1280,1010,403,69,9238
E02004116,4717,1216,977,830,355,78,8173
E02004117,4260,1185,1049,917,401,50,7862
E02006804,5072,1259,863,733,382,100,8409
E02004118,4243,1220,883,597,302,59,7304
E02004119,8012,1657,1028,847,397,54,11995
E02004120,6313,1337,1195,750,318,56,9969
E02004121,4760,1411,950,806,361,95,8383
E02004122,3922,1081,904,776,307,71,7061
E02004123,3551,1240,956,693,378,74,6892
E02004124,4673,1121,906,760,336,47,7843
E02004125,5550,1336,1116,833,347,58,9240
E02004126,4204,1187,961,719,318,82,7471
E02004128,6368,1825,1411,1306,442,113,11465
E02006919,7838,1362,938,632,253,53,11076
E02006920,5979,1179,718,507,157,22,8562
E02004129,2523,984,884,947,382,86,5806
E02004130,3074,736,764,846,505,123,6048
E02004131,2815,795,768,665,376,82,5501
E02004132,4333,1447,1347,1081,444,108,8760
E02004133,4608,1288,1339,1314,633,137,9319
E02004134,9232,1618,1209,909,407,87,13462
E02004135,3278,1317,1504,1425,643,183,8350
E02004136,4430,1361,1215,1170,599,132,8907
E02004137,2066,878,957,961,425,108,5395
E02004138,2577,1003,1248,1581,905,221,7535
E02004139,3057,1011,1009,1164,640,150,7031
E02004140,1568,646,918,1039,815,252,5238
E02004141,2912,979,959,822,380,100,6152
E02004142,3908,877,874,743,357,76,6835
E02004143,3182,932,960,932,409,61,6476
E02004144,3351,948,1056,964,496,121,6936
E02004145,2246,755,1091,1252,689,185,6218
E02004146,4218,1133,929,722,347,65,7414
E02004147,4457,1043,876,650,290,71,7387
E02004148,2939,1005,1128,1320,803,319,7514
E02004149,8840,772,835,728,362,93,11630
E02004150,5043,781,616,372,180,27,7019
E02004151,5831,1209,890,781,513,144,9368
E02004152,8014,478,428,331,237,97,9585
E02004153,5188,955,681,546,172,23,7565
E02004154,6490,783,501,449,241,74,8538
E02004155,4510,1031,871,671,368,90,7541
E02004156,9636,894,723,509,265,61,12088
E02004157,4402,768,615,507,284,144,6720
E02004158,5629,1030,664,519,253,88,8183
E02004159,8502,1533,1145,932,373,65,12550
E02004160,4114,993,842,738,466,122,7275
E02004161,5365,1129,754,575,381,83,8287
E02004162,4481,962,784,641,346,128,7342
E02004163,4155,941,972,984,509,153,7714
E02004164,3181,1137,1129,914,410,74,6845
E02004165,4521,1229,1138,1149,536,114,8687
E02004166,3582,1108,958,787,336,68,6839
E02004167,4843,931,709,573,306,77,7439
E02004168,3792,820,739,585,301,72,6309
E02004169,3920,1218,952,770,369,91,7320
E02004170,5296,1268,993,774,365,99,8795
E02004171,4604,1236,1102,920,408,92,8362
E02004172,3111,1113,993,790,290,73,6370
E02004173,3702,1271,1141,870,358,78,7420
E02004174,4552,1077,920,825,418,133,7925
E02004175,2869,834,778,581,236,85,5383
E02004176,2210,1042,988,823,337,83,5483
E02004177,3156,880,828,671,283,85,5903
E02004178,2738,819,770,693,297,74,5391
E02004179,5474,1186,1006,1080,562,128,9436
E02004180,3105,972,971,724,309,69,6150
E02004181,3252,836,698,620,354,70,5830
E02004182,3852,824,694,583,316,74,6343
E02004183,2955,815,733,854,430,108,5895
E02004184,5621,1264,895,727,317,67,8891
E02004185,2848,943,931,1008,528,139,6397
E02004186,5203,1398,1098,1039,435,73,9246
E02004187,5076,1545,1394,1234,586,136,9971
E02004188,2933,1255,1117,1003,414,104,6826
E02004189,3419,1038,813,570,262,33,6135
E02004190,3936,1490,1298,1028,467,98,8317
E02004191,4534,1356,1298,1052,472,132,8844
E02004192,3115,1300,1363,1144,491,80,7493
E02004193,6624,1906,1456,1146,509,116,11757
E02004194,3625,1161,1137,828,378,97,7226
E02004195,2482,814,896,824,313,98,5427
E02004196,3658,1223,1235,1064,442,84,7706
E02004197,2874,1025,1127,1141,520,87,6774
E02004198,3213,966,907,814,463,133,6496
E02004199,2139,871,1036,1068,481,69,5664
E02004200,2070,783,941,906,394,71,5165
E02004201,2361,859,915,830,348,70,5383
E02004202,4755,1309,1120,941,403,112,8640
E02004203,2468,1080,1025,826,373,112,5884
E02004204,5010,1497,1388,1166,575,119,9755
E02004205,4283,1326,1337,1053,440,60,8499
E02004206,2758,1019,1100,1119,536,178,6710
E02004207,3271,1008,878,819,409,66,6451
E02004208,3942,1290,1353,1239,504,140,8468
E02004209,4933,1406,1027,979,431,131,8907
E02004210,3478,981,952,758,457,182,6808
E02004211,2596,1057,1225,1157,487,176,6698
E02004212,3485,971,767,626,239,62,6150
E02004213,5301,1152,907,650,249,129,8388
E02004214,3897,884,629,528,245,72,6255
E02004215,3211,841,696,574,312,134,5768
E02004216,2771,907,824,694,342,65,5603
E02004217,4189,1290,1121,942,388,105,8035
E02004218,2908,1021,949,812,386,69,6145
E02004219,2486,968,831,830,405,96,5616
E02004220,2583,966,1059,968,441,81,6098
E02004221,2530,798,1118,1157,602,176,6381
E02004222,3263,955,806,594,279,62,5959
E02004223,7792,1735,1580,1154,478,75,12814
E02004224,2861,1124,1092,958,364,109,6508
E02004225,3364,810,748,651,316,91,5980
E02004226,3065,1210,1409,1097,448,83,7312
E02004227,4894,1661,1645,1276,547,110,10133
E02004228,3104,1216,1312,996,394,60,7082
E02004229,5002,1542,1349,1140,495,119,9647
E02004230,4191,1107,906,851,445,109,7609
E02004231,3238,1233,1115,944,363,52,6945
E02004232,2981,1220,1148,865,355,79,6648
E02004233,6230,1864,1763,1662,824,202,12545
E02004234,2455,1075,1090,937,406,105,6068
E02004235,2710,1075,1036,990,422,101,6334
E02004356,4531,1097,827,639,289,80,7463
E02004357,5004,1040,867,654,241,54,7860
E02004358,4262,1028,987,1027,567,128,7999
E02004359,4051,1199,1018,988,654,189,8099
E02004361,4348,1261,983,907,520,149,8168
E02004362,5608,1261,926,696,380,90,8961
E02004363,3530,992,840,797,565,255,6979
E02004364,4259,1232,1021,945,616,181,8254
E02004365,6032,1022,741,380,171,46,8392
E02004366,4419,845,838,855,688,262,7907
E02004367,2777,878,1031,1320,994,332,7332
E02006857,4821,1221,1108,1153,521,134,8958
E02006858,3725,1111,1095,1062,328,52,7373
E02004368,4977,1288,1062,852,285,65,8529
E02004369,4235,1475,1419,1572,779,210,9690
E02004370,5175,1062,857,611,257,47,8009
E02004371,4455,987,806,604,276,50,7178
E02004372,5144,935,625,437,204,27,7372
E02004373,5306,1273,995,818,336,116,8844
E02004374,4240,1296,956,735,299,132,7658
E02004375,5093,1412,1045,676,262,92,8580
E02004376,4567,1047,751,471,176,77,7089
E02004377,5891,1556,1399,1189,599,310,10944
E02004378,5265,1431,1016,673,294,89,8768
E02004379,4303,1297,1068,907,352,87,8014
E02004380,4727,1499,1327,1039,740,232,9564
E02004381,5757,1682,1189,916,464,128,10136
E02004382,3323,903,915,871,491,139,6642
E02004383,4518,1296,852,722,347,72,7807
E02004384,4289,1223,985,808,436,134,7875
E02004385,4110,1105,1024,895,428,103,7665
E02004386,3662,1023,835,798,336,75,6729
E02004387,4425,816,568,380,145,32,6366
E02004388,4461,1013,911,868,458,120,7831
E02004389,3944,1467,1511,1649,895,312,9778
E02004390,3836,1094,1179,1261,672,137,8179
E02004391,3196,950,921,881,540,194,6682
E02004392,5044,1517,1270,1076,445,100,9452
E02004393,2656,1103,1131,1059,453,93,6495
E02004394,3688,1450,1231,1121,475,113,8078
E02004395,3786,1338,1280,1243,565,120,8332
E02004396,3557,1441,1669,1682,650,159,9158
E02004397,4601,1289,1182,980,555,128,8735
E02004398,5869,1261,1005,928,452,154,9669
E02004399,3755,1125,1215,1274,684,203,8256
E02004400,3036,1455,1948,2228,1152,311,10130
E02004401,2933,1038,1340,1552,1010,261,8134
E02004402,4852,1312,1293,1247,652,285,9641
E02004403,3666,1160,944,770,310,64,6914
E02004404,3412,1137,941,687,332,65,6574
E02004405,3669,831,780,746,365,68,6459
E02004406,3400,1187,1052,1134,629,191,7593
E02004407,3862,1413,1134,1028,534,123,8094
E02004408,4803,1314,974,720,294,55,8160
E02004409,2534,998,880,691,281,67,5451
E02004410,3948,1503,1284,1105,430,135,8405
E02004411,4822,1230,1116,980,396,98,8642
E02004412,4326,1205,1026,1038,455,110,8160
E02004413,3378,1204,1010,928,458,127,7105
E02004414,3863,1064,692,572,206,69,6466
E02004415,3496,1239,1092,763,343,83,7016
E02004416,2992,1116,1058,893,346,85,6490
E02004417,3138,879,752,827,494,154,6244
E02004418,3147,779,704,708,391,71,5800
E02004419,3577,863,662,646,306,96,6150
E02004420,7189,1869,1946,1792,878,197,13871
E02004421,4957,1269,1145,1161,664,175,9371
E02004422,5659,1629,1485,1376,695,134,10978
E02004423,3201,1122,1119,1294,656,140,7532
E02004424,4067,1062,862,771,311,32,7105
E02004425,4495,1063,771,599,377,67,7372
E02004426,4825,1179,779,724,466,112,8085
E02004427,4210,1198,898,964,550,93,7913
E02004428,4048,964,703,669,420,141,6945
E02004429,3679,1135,934,1019,511,104,7382
E02004430,5078,1212,888,705,294,67,8244
E02004431,6700,1304,847,678,255,47,9831
E02004432,4008,1010,851,734,326,56,6985
E02004433,5784,1265,867,690,314,98,9018
E02004434,5688,1183,942,642,259,50,8764
E02004435,6448,1175,820,526,297,73,9339
E02004436,5652,955,858,536,190,56,8247
E02004437,6015,1180,974,769,335,63,9336
E02004438,6652,1127,804,528,488,147,9746
E02004439,7702,1124,638,429,205,25,10123
E02004440,5730,1155,662,517,372,39,8475
E02004441,4766,1020,930,708,272,42,7738
E02004442,6207,1057,756,475,205,37,8737
E02004443,6699,1283,854,639,426,68,9969
E02004444,5664,1423,1026,750,297,64,9224
E02004445,5727,1090,825,646,281,52,8621
E02004446,3509,1243,1010,747,301,57,6867
E02004447,2665,1122,978,802,295,53,5915
E02004448,3929,1135,944,805,315,63,7191
E02004449,5204,1214,913,785,361,93,8570
E02004450,3050,1158,986,785,311,64,6354
E02004451,4702,1359,1138,1023,517,115,8854
E02004452,5188,1313,1122,1007,450,201,9281
E02004453,4652,965,707,618,288,60,7290
E02004454,6140,1183,907,726,409,102,9467
E02004455,4644,1236,872,803,272,45,7872
E02004456,6652,1342,920,685,319,66,9984
E02004457,6469,1476,1059,841,394,108,10347
E02004458,5998,1417,979,822,359,105,9680
E02004459,5863,1602,1330,1161,543,127,10626
E02004460,5666,1261,1027,880,300,43,9177
E02004461,4085,752,499,407,108,44,5895
E02004462,7221,1414,1068,924,475,131,11233
E02004463,4414,1183,1045,815,410,134,8001
E02004464,5182,1698,1318,1182,588,147,10115
E02004465,3186,1108,718,695,471,82,6260
E02004466,5038,1200,834,620,409,121,8222
E02004467,5421,1099,786,672,290,77,8345
E02004468,5714,1731,1107,1061,715,183,10511
E02004469,3995,1069,812,693,376,60,7005
E02004470,8360,1348,846,750,439,158,11901
E02004471,5233,1198,941,637,400,114,8523
E02004472,3380,1023,749,570,344,73,6139
E02004473,4560,1038,884,941,450,48,7921
E02004474,4063,1114,966,985,531,88,7747
E02004475,3734,1062,804,792,333,61,6786
E02004476,4404,1222,969,1008,442,68,8113
E02004477,2761,896,897,897,520,78,6049
E02004478,3539,1022,729,729,417,105,6541
E02004479,4594,1265,957,952,489,113,8370
E02004480,4477,935,886,666,185,35,7184
E02004481,3052,861,995,1279,583,62,6832
E02004482,5403,1141,910,727,309,61,8551
E02004483,4239,1169,1263,1127,475,71,8344
E02004484,4066,1169,1147,1076,411,69,7938
E02004485,5229,1157,897,732,325,65,8405
E02004486,5126,1166,936,912,490,88,8718
E02004487,4755,991,853,650,295,80,7624
E02004488,5751,1127,1026,751,392,88,9135
E02004489,5966,1349,902,716,298,38,9269
E02004490,5665,1041,686,559,259,65,8275
E02004491,4765,1178,792,627,361,56,7779
E02004492,6485,1330,804,510,230,56,9415
E02004493,7326,1325,834,586,349,106,10526
E02004494,9811,1119,690,570,413,142,12745
E02004495,4492,1239,1024,1005,638,114,8512
E02004496,5250,989,692,662,390,99,8082
E02004497,4065,1143,950,982,552,118,7810
E02004498,6306,1374,923,891,426,89,10009
E02004499,4057,989,739,680,282,61,6808
E02004500,4811,1461,1161,1101,537,78,9149
E02004501,3857,1043,883,841,409,55,7088
E02004502,3599,1192,951,858,420,71,7091
E02004503,4749,1053,992,821,292,75,7982
E02004504,4729,1255,1104,620,211,77,7996
E02004505,2999,916,782,795,411,67,5970
E02004506,3787,1178,947,817,348,72,7149
E02004507,7054,1329,807,491,216,36,9933
E02004508,3454,1042,832,795,338,50,6511
E02004509,11368,1683,881,625,266,62,14885
E02004512,8177,1186,876,777,455,139,11610
E02004513,11036,948,723,614,235,34,13590
E02004514,3261,824,583,578,331,91,5668
E02004515,5070,1302,1027,861,329,80,8669
E02004516,11364,1330,735,468,175,22,14094
E02004517,5434,1196,959,937,508,102,9136
E02004518,5564,992,602,450,222,39,7869
E02004519,3751,1072,977,852,566,96,7314
E02004520,7355,980,555,426,177,36,9529
E02004521,5793,1385,964,658,328,61,9189
E02004522,8581,1069,973,980,327,80,12010
E02004523,7065,1361,927,622,295,65,10335
E02004524,4297,1429,1212,994,401,57,8390
E02004525,3855,1109,1025,1092,446,70,7597
E02004526,2973,1144,1138,1262,631,137,7285
E02006922,7959,1933,1609,1531,767,144,13943
E02004527,5032,1399,1038,888,436,58,8851
E02004528,4344,1391,1136,987,488,81,8427
E02004529,3509,1259,919,759,313,78,6837
E02004530,3605,978,770,683,438,81,6555
E02004531,4166,1002,751,651,384,124,7078
E02004532,3788,850,700,592,375,70,6375
E02004533,4496,1070,785,670,373,109,7503
E02004534,6071,1222,748,664,278,61,9044
E02004535,3271,911,730,629,329,54,5924
E02004536,3369,927,802,687,362,116,6263
E02004537,6245,1289,813,527,264,79,9217
E02004538,6037,1483,928,781,457,111,9797
E02004539,5307,1046,731,549,298,77,8008
E02004540,3698,935,648,457,267,61,6066
E02004541,7340,1667,1085,1011,531,148,11782
E02004542,3725,1083,826,582,333,92,6641
E02004543,4790,901,726,519,295,90,7321
E02004544,5743,1128,893,684,354,83,8885
E02004545,5090,975,769,451,284,88,7657
E02004546,5370,1014,784,459,313,76,8016
E02004547,6566,1080,801,412,343,84,9286
E02004548,6070,1290,659,498,161,28,8706
E02004549,5151,1073,762,439,336,76,7837
E02004550,5690,968,728,545,433,87,8451
E02004551,4760,938,776,546,333,67,7420
E02004552,3781,901,813,605,229,32,6361
E02004553,4787,915,629,495,306,38,7170
E02004554,4757,993,724,548,217,39,7278
E02004555,3221,1008,997,836,308,65,6435
E02004556,3500,1324,1060,1085,439,83,7491
E02004557,4950,1229,1086,858,347,78,8548
E02004558,3594,1072,779,824,538,132,6939
E02004559,3926,1257,1066,943,455,64,7711
E02004560,4872,1528,1271,1020,368,118,9177
E02004561,5355,1862,1580,1277,528,65,10667
E02004562,3867,1223,1262,1075,444,87,7958
E02004563,2911,1026,1019,1079,451,73,6559
E02004564,4308,1333,1149,936,455,73,8254
E02004565,8756,2450,1933,1838,882,149,16008
E02004566,3724,883,595,463,243,82,5990
E02004567,4482,1216,987,941,543,91,8260
E02004568,5995,1312,845,720,275,66,9213
E02004569,4847,1114,868,743,419,64,8055
E02004570,4971,1222,1024,1031,559,127,8934
E02004571,4317,1222,1021,988,528,114,8190
E02004572,4332,1263,1075,857,317,61,7905
E02004573,3942,872,782,553,305,75,6529
E02004574,4706,959,855,847,385,72,7824
E02004575,6157,1860,1563,1323,648,136,11687
E02004576,4454,1343,1358,1238,589,128,9110
E02004577,2949,988,834,599,261,49,5680
E02004578,2859,967,1208,1391,711,195,7331
E02004579,3181,1165,1242,1160,455,63,7266
E02004580,4727,1661,1987,2345,1197,277,12194
E02004581,3844,1212,1127,1137,480,117,7917
E02004582,2861,950,1155,1326,597,114,7003
E02004583,4458,1248,1230,1272,534,111,8853
E02004584,2143,844,1207,1600,739,159,6692
E02004585,4770,1140,1096,1148,436,84,8674
E02004586,4103,1172,1132,1160,655,147,8369
E02004587,4773,1029,1003,864,372,77,8118
E02004588,4192,1046,791,622,390,138,7179
E02004589,4099,1119,974,928,469,144,7733
E02004590,3420,1321,1433,1529,608,91,8402
E02004591,4110,1246,947,701,333,97,7434
E02004592,8091,1903,1455,1243,736,240,13668
E02004593,4637,1480,1166,938,401,87,8709
E02004594,5123,1309,969,873,348,94,8716
E02004595,8808,2209,1538,1235,558,143,14491
E02004596,6970,1468,1019,774,313,60,10604
E02004597,5134,1358,965,730,366,88,8641
E02004598,6617,1706,1251,1007,512,113,11206
E02004599,4331,1354,930,777,338,85,7815
E02004600,3197,812,671,540,194,33,5447
E02004601,2454,789,778,812,450,94,5377
E02004602,4165,765,662,503,238,59,6392
E02004603,6345,703,567,391,211,48,8265
E02004604,5599,1027,730,459,239,60,8114
E02004605,3593,762,601,456,169,34,5615
E02004606,6875,1242,891,573,368,118,10067
E02004607,6129,1221,984,677,329,118,9458
E02004608,6653,1217,942,758,515,205,10290
E02004609,4052,1021,730,778,377,54,7012
E02004610,4235,1046,879,883,556,125,7724
E02004611,7031,1719,1127,948,563,111,11499
E02004612,4956,1404,1083,971,583,104,9101
E02004613,3257,1102,825,775,410,101,6470
E02004614,2961,789,648,569,389,119,5475
E02004615,3591,1467,1353,1258,662,147,8478
E02004616,4599,1522,1349,1280,737,164,9651
E02004617,4907,1413,1175,1089,518,104,9206
E02004618,3643,1315,1176,803,291,70,7298
E02004619,3421,1297,1215,942,411,80,7366
E02004620,4837,1301,1027,787,311,61,8324
E02004621,3594,794,657,742,594,170,6551
E02004622,4625,982,761,701,388,129,7586
E02004623,4537,1440,1321,1144,551,108,9101
E02004624,3371,1171,907,783,304,59,6595
E02004625,5022,1525,1406,1176,490,87,9706
E02004626,5426,1591,1435,1208,565,83,10308
E02004627,3282,896,820,767,330,92,6187
E02004628,4368,1267,1100,884,357,77,8053
E02004629,7463,1929,1729,1282,567,128,13098
E02004630,3084,1142,1013,863,411,101,6614
E02004631,2173,1057,871,712,238,48,5099
E02004632,5793,1671,1491,1216,584,138,10893
E02004633,4246,1458,1300,1042,375,65,8486
E02004634,5779,1640,1317,1214,556,108,10614
E02004635,3958,1069,1011,906,423,72,7439
E02004636,4368,1321,928,825,395,91,7928
E02004637,5633,1137,993,743,478,160,9144
E02004638,3411,846,633,532,247,77,5746
E02004639,6992,1184,813,649,314,136,10088
E02004640,6079,925,653,366,166,34,8223
E02004641,3556,1085,929,1112,583,106,7371
E02004642,7666,1748,1306,813,363,67,11963
E02004643,5593,1127,646,358,226,25,7975
E02004644,5779,1317,863,593,298,64,8914
E02004645,5243,1501,1155,837,345,54,9135
E02004646,5597,1236,983,705,331,72,8924
E02004647,3156,948,771,645,353,85,5958
E02004648,2985,812,716,853,335,46,5747
E02004649,4931,1075,631,401,181,82,7301
E02004650,11398,1607,958,531,196,21,14711
E02004651,6654,1256,1022,760,315,38,10045
E02004652,2945,1097,1011,1001,458,87,6599
E02004653,3565,1171,982,749,336,58,6861
E02004654,6871,1779,1424,1148,530,118,11870
E02004655,4731,1173,991,728,353,55,8031
E02004656,6954,1902,1379,882,472,98,11687
E02004657,3684,1221,887,687,300,38,6817
E02004658,3387,1096,736,669,337,35,6260
E02004659,3482,1071,1045,886,381,46,6911
E02004660,2970,1057,964,989,599,106,6685
E02004661,4517,1349,1157,1040,479,75,8617
E02004662,3449,1079,885,679,329,33,6454
E02004663,3493,1041,957,712,329,70,6602
E02004664,4788,1031,777,612,366,76,7650
E02004665,4724,1339,1215,1056,450,91,8875
E02004666,7955,1728,1279,905,367,111,12345
E02004667,6008,1751,1511,1368,659,150,11447
E02004668,4269,1453,1427,1324,577,129,9179
E02004669,3697,1171,1156,946,433,93,7496
E02004670,9507,2170,1564,1443,827,199,15710
E02004671,3682,1101,1108,803,286,53,7033
E02004672,7951,1873,1369,1229,672,132,13226
E02004673,3724,1051,858,798,401,70,6902
E02004674,7597,1493,1211,867,403,110,11681
E02004675,4287,1145,830,708,320,48,7338
E02004676,3889,1345,1064,904,449,57,7708
E02004677,4172,1323,957,745,325,62,7584
E02004678,3701,1340,970,822,359,67,7259
E02004679,5680,1540,1013,782,357,73,9445
E02004680,5338,1050,744,393,120,20,7665
E02004681,10528,1461,884,749,228,63,13913
E02004682,5509,1240,844,509,177,35,8314
E02004683,4996,1025,572,475,316,75,7459
E02004684,7469,1339,745,646,273,41,10513
E02004685,5368,944,612,459,263,59,7705
E02004686,5969,1002,671,493,273,68,8476
E02004687,5257,1010,595,472,179,14,7527
E02004688,4857,1143,731,631,357,78,7797
E02004689,2498,792,812,870,364,99,5435
E02004690,4851,1210,840,598,275,59,7833
E02004691,3714,1400,1096,917,480,129,7736
E02004692,3252,1118,1072,1092,477,68,7079
E02004693,4762,1010,761,477,176,39,7225
E02004694,4027,1092,825,756,349,85,7134
E02004695,6086,1385,661,373,97,7,8609
E02004696,3796,1033,842,746,324,87,6828
E02004697,3635,1098,848,729,336,123,6769
E02004698,3946,768,571,547,357,111,6300
E02004699,5851,1655,1293,1208,672,167,10846
E02004700,3923,850,433,300,102,34,5642
E02004702,4959,1257,914,678,314,35,8157
E02004703,6175,2057,1702,1567,643,143,12287
E02004704,2969,997,736,600,241,46,5589
E02004705,5347,1380,1023,949,526,116,9341
E02004706,4090,1178,1018,891,466,143,7786
E02004707,6016,1822,1546,1285,680,174,11523
E02004708,5311,1253,1037,977,517,124,9219
E02004709,4459,1394,1183,912,411,50,8409
E02004710,3409,1111,870,751,269,48,6458
E02006829,3343,1117,1011,923,556,146,7096
E02006838,3017,1229,1013,983,517,127,6886
E02004712,4867,1322,922,1106,635,155,9007
E02004713,4517,1043,1055,910,394,123,8042
E02004714,4186,1060,1043,919,419,96,7723
E02004715,6041,1135,984,707,347,100,9314
E02004716,5332,1293,1040,808,355,75,8903
E02004717,8389,1456,905,678,439,101,11968
E02004718,6643,1160,786,427,203,73,9292
E02004719,6175,1669,1292,1015,426,112,10689
E02004720,5895,1706,1463,1213,626,160,11063
E02004721,7943,1343,824,479,199,31,10819
E02004722,4029,1010,899,751,393,100,7182
E02004723,5560,1438,1205,1064,551,101,9919
E02004724,5245,1217,923,660,315,48,8408
E02004725,2890,824,715,562,335,113,5439
E02004726,3209,936,733,622,284,32,5816
E02004727,6418,1598,906,684,301,51,9958
E02004728,5554,1422,1004,788,384,123,9275
E02004729,4447,1036,780,788,334,71,7456
E02004730,4258,1506,1154,1130,721,159,8928
E02004731,4310,1283,1062,831,412,109,8007
E02004732,4797,1318,1072,873,463,94,8617
E02004733,4608,1249,1027,775,349,75,8083
E02004734,6120,1621,1219,1032,534,143,10669
E02004735,3693,1099,1035,1073,592,100,7592
E02004736,3856,1178,1125,1169,514,106,7948
E02004737,5156,1015,707,634,372,92,7976
E02004738,3923,1115,1005,872,441,99,7455
E02004739,3168,1036,1002,1047,619,113,6985
E02004740,3319,1103,1058,1094,591,119,7284
E02004741,4459,1110,997,868,386,71,7891
E02004742,4132,1107,1055,796,372,59,7521
E02004743,4425,1152,896,673,265,45,7456
E02004744,7629,1033,668,337,152,19,9838
E02004745,5888,1335,876,670,237,37,9043
E02004746,5928,1552,1439,1476,684,160,11239
E02004747,4074,1028,804,587,296,49,6838
E02004748,6339,1427,1025,809,391,63,10054
E02004749,3358,1042,1017,986,656,188,7247
E02004750,3984,1287,1028,812,457,143,7711
E02004751,4376,1216,977,950,438,94,8051
E02004752,4558,1302,1035,852,289,26,8062
E02004753,6343,1497,1158,1086,470,65,10619
E02004754,4006,1048,841,831,375,82,7183
E02004755,8517,1615,884,735,494,153,12398
E02004756,5097,1467,978,709,280,79,8610
E02004757,4149,1260,934,1003,499,93,7938
E02004758,5086,1409,957,890,478,133,8953
E02004759,4885,1343,845,879,451,108,8511
E02004760,6792,1328,779,641,342,104,9986
E02004761,4347,864,635,569,277,70,6762
E02004764,3737,1362,1142,1205,705,109,8260
E02004765,3278,962,801,701,293,60,6095
E02004766,4277,980,719,610,370,100,7056
E02004767,4409,807,548,388,180,30,6362
E02004768,3393,832,712,438,192,43,5610
E02004769,4460,812,556,345,155,43,6371
E02004770,4709,968,672,443,264,21,7077
E02004771,6286,1246,881,610,306,70,9399
E02004772,5203,1521,1252,998,513,93,9580
E02004774,4471,1450,1547,1428,881,261,10038
E02004775,5496,1497,1304,1075,567,159,10098
E02004776,2436,946,1070,1037,478,101,6068
E02004777,2440,761,813,960,487,138,5599
E02004778,2518,1016,1015,1081,497,114,6241
E02006822,4923,1547,1146,886,559,120,9181
E02006830,4547,855,664,548,217,42,6873
E02006831,3106,932,888,813,456,117,6312
E02004779,4806,1796,1748,1425,766,222,10763
E02004780,3389,848,750,633,299,89,6008
E02004781,5121,1332,931,613,330,79,8406
E02004782,4592,1108,910,794,471,122,7997
E02004783,4406,1125,804,585,324,78,7322
E02004784,2424,1005,862,813,492,147,5743
E02004785,2473,922,884,841,433,113,5666
E02004786,5313,1257,1037,718,240,71,8636
E02004787,3260,1069,1109,1184,653,168,7443
E02004788,3568,1171,1014,921,412,85,7171
E02004789,5779,1599,1331,1133,677,174,10693
E02004790,4475,1086,919,880,609,130,8099
E02004791,3452,729,668,510,205,44,5608
E02004792,3909,1340,1358,1181,542,109,8439
E02004793,3146,1243,1191,1182,609,196,7567
E02004794,3231,1072,1162,966,404,128,6963
E02004795,4355,1441,1348,1286,770,211,9411
E02004796,3944,1478,1607,1779,849,170,9827
E02004797,4487,1232,1102,869,420,103,8213
E02004798,3567,884,705,710,392,72,6330
E02004799,3677,993,1024,1334,831,284,8143
E02004800,2059,1031,1454,1780,1009,331,7664
E02004801,2568,1057,1350,1697,961,341,7974
E02004802,4050,979,701,544,271,76,6621
E02004803,4883,1064,637,507,174,45,7310
E02004804,4209,1055,749,647,225,42,6927
E02004805,4960,1205,921,678,277,123,8164
E02004806,5061,1277,826,496,196,44,7900
E02004807,5829,1341,835,713,394,77,9189
E02004808,8189,1425,804,548,322,69,11357
E02004809,7934,617,379,349,143,25,9447
E02004810,5371,1063,556,397,162,36,7585
E02004811,4413,1170,816,665,356,112,7532
E02004812,3997,1068,693,515,193,28,6494
E02004813,3732,963,590,465,253,70,6073
E02004814,3852,1304,879,692,278,48,7053
E02004815,5531,967,604,419,134,13,7668
E02004816,12016,2057,1294,1001,496,101,16965
E02004817,4877,1183,820,687,356,86,8009
E02004818,5668,1529,1104,1144,561,97,10103
E02004819,4532,1311,841,751,490,134,8059
E02004820,4147,1126,882,718,316,65,7254
E02004821,2506,871,763,767,297,61,5265
E02004822,3631,1405,1196,978,477,87,7774
E02004823,4428,1282,1179,1133,542,90,8654
E02004824,2667,795,784,891,674,157,5968
E02004825,5555,1540,1470,1421,599,163,10748
E02004826,4590,1217,1098,1007,431,149,8492
E02004827,4686,1256,839,476,189,50,7496
E02004828,3452,1003,1011,715,389,82,6652
E02004829,3396,834,743,592,243,70,5878
E02004830,3870,1102,856,726,271,51,6876
E02004831,5514,1243,970,993,738,247,9705
E02004832,4043,1363,1163,1166,585,141,8461
E02004833,6376,1278,930,771,462,150,9967
E02004834,5432,955,683,630,334,112,8146
E02004835,7248,1293,936,864,487,168,10996
E02004836,5153,649,417,336,182,45,6782
E02004837,4750,1167,950,827,390,92,8176
E02004838,5261,1467,1188,1033,448,129,9526
E02004839,4232,1501,1363,1053,502,56,8707
E02004840,5008,1529,1297,1145,570,126,9675
E02004841,7059,1770,1269,963,544,103,11708
E02004842,5788,1510,1264,1020,510,164,10256
E02004843,4041,976,724,772,378,69,6960
E02004844,4809,974,687,479,301,68,7318
E02004845,4927,1062,741,724,444,87,7985
E02004846,3330,1017,717,702,347,71,6184
E02004847,7277,1308,972,720,322,62,10661
E02004848,4837,1093,798,610,277,47,7662
E02004849,3741,1222,819,634,297,48,6761
E02004850,4660,1118,743,567,361,56,7505
E02004851,3632,824,651,520,247,55,5929
E02004852,4976,972,723,609,452,63,7795
E02004853,4168,896,646,538,326,65,6639
E02004854,4854,1119,661,578,422,96,7730
E02004855,5833,1017,605,447,217,31,8150
E02004856,3351,921,696,494,187,39,5688
E02004857,3451,947,687,527,292,73,5977
E02004858,3181,744,545,446,203,35,5154
E02004859,2814,870,684,572,279,40,5259
E02004860,4339,722,591,273,70,8,6003
E02004861,2733,856,741,653,399,110,5492
E02004862,5293,918,1001,552,193,37,7994
E02004863,5504,973,693,435,329,95,8029
E02004864,3789,967,760,558,374,99,6547
E02004865,3571,888,553,379,226,64,5681
E02004866,4245,955,709,476,270,105,6760
E02004867,4156,911,659,535,334,62,6657
E02004868,4894,849,615,447,327,111,7243
E02004869,3636,857,574,433,230,62,5792
E02004870,7856,1374,990,633,383,117,11353
E02004871,3302,736,549,369,175,65,5196
E02004872,4355,1059,813,686,444,57,7414
E02004873,7623,1555,1131,775,375,69,11528
E02004874,3962,903,685,416,196,62,6224
E02004875,7089,1238,860,571,304,104,10166
E02004876,5368,1403,1096,967,440,75,9349
E02004877,2967,819,614,514,283,60,5257
E02004896,4388,1199,881,957,660,234,8319
E02004897,3925,972,755,652,332,59,6695
E02004898,4552,1087,877,641,346,134,7637
E02004899,3324,814,598,420,215,84,5455
E02004900,4602,1285,896,761,476,88,8108
E02004901,6144,1270,782,586,261,102,9145
E02004902,5923,1009,738,466,248,49,8433
E02004903,5139,1089,648,495,240,69,7680
E02004904,4452,831,588,380,140,35,6426
E02004905,4017,955,709,560,263,76,6580
E02004906,7336,1264,898,622,279,66,10465
E02004907,6176,1394,1041,900,474,86,10071
E02004908,5448,1373,1075,1179,722,108,9905
E02004909,3788,763,544,409,217,61,5782
E02004910,6740,1478,1188,1138,603,113,11260
E02004911,4041,963,716,511,408,88,6727
E02004912,6450,1627,1099,804,523,121,10624
E02004913,9705,2259,1571,1179,531,146,15391
E02004914,5561,981,715,570,327,77,8231
E02004915,3662,797,542,440,232,41,5714
E02004916,4135,1028,827,884,472,93,7439
E02004917,3565,924,717,722,372,92,6392
E02004918,6063,1081,661,414,256,47,8522
E02004919,5135,980,794,568,290,56,7823
E02004920,7006,1596,1191,991,679,206,11669
E02004921,4933,1084,759,677,389,62,7904
E02004922,5290,1694,1241,1042,493,98,9858
E02004923,5660,1590,1351,1048,489,96,10234
E02004956,5306,1384,953,833,427,106,9009
E02004957,7183,1461,976,663,228,71,10582
E02004958,4539,1283,852,745,398,106,7923
E02004959,3350,935,694,552,415,173,6119
E02004960,3323,893,645,554,292,50,5757
E02004961,6005,1480,998,764,422,60,9729
E02004962,5673,1300,813,666,397,105,8954
E02004963,4912,974,789,500,189,37,7401
E02004964,3561,779,549,403,205,52,5549
E02004965,4029,936,725,737,446,81,6954
E02004966,4285,1068,904,739,447,86,7529
E02004967,5533,981,682,352,213,56,7817
E02004968,4960,1008,652,476,281,59,7436
E02004969,4477,1050,700,478,339,47,7091
E02004970,5460,986,738,562,350,84,8180
E02004971,5645,1009,590,409,231,55,7939
E02004972,3699,748,655,464,237,41,5844
E02004973,6080,933,511,274,124,21,7943
E02004974,5841,987,741,637,413,155,8774
E02004975,5181,1105,763,594,327,62,8032
E02004976,8245,997,566,359,203,55,10425
E02004977,6702,948,537,330,164,42,8723
E02004978,7158,958,647,369,204,54,9390
E02004979,4326,906,745,535,242,46,6800
E02004996,4840,1223,976,840,423,94,8396
E02004997,3788,1403,1146,1070,458,106,7971
E02004998,3775,1052,772,721,359,52,6731
E02004999,10221,1942,1358,1182,491,147,15341
E02005000,8540,1387,896,677,290,54,11844
E02005001,5307,1363,1032,888,360,80,9030
E02005002,6331,1285,892,666,314,47,9535
E02005003,7209,1193,667,498,177,37,9781
E02005004,8770,1867,896,603,244,45,12425
E02005005,5557,1472,1171,1018,366,88,9672
E02005006,2874,1009,790,774,314,99,5860
E02005007,5159,1438,1127,1008,420,107,9259
E02005008,3496,1298,1184,1394,763,197,8332
E02005009,2900,925,838,836,294,62,5855
E02005010,4694,1045,1007,740,378,203,8067
E02005011,3288,1071,1236,1279,622,162,7658
E02005012,4809,1289,1155,1087,504,98,8942
E02005013,4202,1338,1099,1119,533,130,8421
E02005014,3651,1368,1482,1440,671,172,8784
E02005015,5791,1326,1110,980,375,89,9671
E02005016,4012,1296,1112,927,467,125,7939
E02005017,3723,1141,868,722,345,117,6916
E02005018,4578,1351,1195,1230,512,105,8971
E02005019,3640,911,876,644,313,126,6510
E02005020,4389,995,886,781,395,70,7516
E02005021,8996,825,823,917,367,63,11991
E02005022,7115,724,562,456,230,51,9138
E02005023,8400,742,554,369,231,67,10363
E02005025,8002,947,851,759,422,91,11072
E02005026,4878,1147,954,701,308,93,8081
E02005027,2705,949,741,663,377,118,5553
E02006855,5558,633,421,276,137,45,7070
E02006856,9739,938,803,660,449,142,12731
E02005028,10424,1052,649,371,259,74,12829
E02005029,10363,1329,756,369,167,35,13019
E02005030,8319,1461,848,506,279,49,11462
E02005031,6280,1093,613,375,212,35,8608
E02005032,7391,1325,712,442,224,31,10125
E02005033,5314,979,599,448,138,47,7525
E02005034,4574,1160,831,641,302,51,7559
E02005035,5494,1166,753,635,378,79,8505
E02005036,4564,827,553,428,205,33,6610
E02005037,3963,1136,755,733,474,94,7155
E02005038,3154,849,739,614,359,121,5836
E02005039,4016,1015,770,623,297,61,6782
E02005040,3222,1041,934,803,475,116,6591
E02005041,3627,1174,1079,897,347,87,7211
E02005042,4287,1485,1387,1283,616,136,9194
E02005043,3582,1218,1130,985,465,133,7513
E02005044,2950,1125,1078,966,409,79,6607
E02005045,5552,1336,1178,900,397,77,9440
E02005046,5094,1071,761,714,250,38,7928
E02005047,3880,1191,1072,962,520,142,7767
E02005048,3035,1184,1150,917,384,113,6783
E02005049,2620,1116,1332,1296,520,171,7055
E02005050,5164,1397,1294,1130,615,147,9747
E02005051,9889,1803,1215,855,344,75,14181
E02005052,4951,1054,976,710,355,77,8123
E02005053,6864,1181,950,550,237,57,9839
E02005054,3067,1196,1125,933,362,60,6743
E02005055,6691,971,575,396,165,18,8816
E02005056,7765,1243,855,541,338,105,10847
E02005057,8267,1482,871,636,375,57,11688
E02005058,5687,979,698,471,239,58,8132
E02005059,5821,1534,1115,758,416,105,9749
E02005060,5088,1055,785,638,423,95,8084
E02005061,4696,981,687,586,265,55,7270
E02005062,4152,1019,750,648,363,54,6986
E02005063,4082,1033,794,578,311,63,6861
E02005064,3461,1007,923,835,392,69,6687
E02005065,5656,1094,681,505,288,81,8305
E02005066,3643,1267,1074,1090,511,107,7692
E02005067,2991,982,784,736,283,46,5822
E02005068,4196,1211,835,596,221,47,7106
E02005069,5596,1224,942,823,434,85,9104
E02005070,4672,1385,1102,1256,763,128,9306
E02005071,9148,1257,746,452,299,79,11981
E02005072,4209,1156,987,914,315,61,7642
E02005073,9055,1529,900,565,351,90,12490
E02005074,4402,1111,1034,1021,502,106,8176
E02005075,7396,1473,863,654,342,59,10787
E02005076,7325,1239,717,451,289,55,10076
E02005077,5065,1163,820,723,357,65,8193
E02005078,4548,1488,1356,1121,535,117,9165
E02005079,4996,1265,984,1032,490,111,8878
E02005080,8724,1405,912,911,462,95,12509
E02005081,3067,1069,1010,946,434,86,6612
E02005082,7024,1716,1217,977,407,100,11441
E02005083,3976,1097,908,888,426,59,7354
E02005084,4075,1204,927,782,366,65,7419
E02005085,4156,1265,937,626,314,50,7348
E02005086,3459,937,819,659,288,77,6239
E02005087,4002,1077,910,786,375,42,7192
E02005088,6138,1238,1037,728,441,89,9671
E02005089,3798,975,692,683,373,56,6577
E02005090,2762,919,748,954,463,96,5942
E02005091,3848,1012,895,737,408,83,6983
E02005093,2764,916,912,903,414,67,5976
E02005094,5917,1337,945,806,408,68,9481
E02005095,4128,1139,866,824,462,83,7502
E02005096,6677,1246,891,737,432,149,10132
E02005097,6271,1427,983,801,455,130,10067
E02005098,6208,1519,1007,854,613,250,10451
E02005099,4284,1346,1017,830,330,81,7888
E02005100,5893,1377,1028,898,456,113,9765
E02005101,3843,1249,938,703,295,51,7079
E02006832,3554,786,842,657,170,35,6044
E02005102,2679,1120,1072,994,434,95,6394
E02005103,6746,1362,928,893,334,59,10322
E02005104,4774,1221,998,790,314,58,8155
E02005105,5577,1025,714,420,182,44,7962
E02005106,6133,1391,1027,820,306,70,9747
E02005107,7317,1910,1650,1495,597,167,13136
E02005109,2637,1067,1091,1208,591,227,6821
E02005110,3100,1248,1139,1034,416,90,7027
E02005111,3117,1131,1170,1214,650,208,7490
E02005112,2935,1179,1289,1203,451,119,7176
E02005113,3249,1175,1146,1145,528,139,7382
E02005114,3414,991,970,856,341,58,6630
E02006879,4997,1075,724,469,254,70,7589
E02006880,4093,924,818,709,431,190,7165
E02005115,4815,857,544,311,124,26,6677
E02005116,4432,893,640,509,232,35,6741
E02005117,2992,1026,989,993,335,53,6388
E02005118,6785,1594,1097,888,363,70,10797
E02005119,3564,903,813,696,284,45,6305
E02005120,4610,1390,1279,1002,328,47,8656
E02005121,10068,1861,1201,764,267,52,14213
E02005122,3916,1232,941,808,370,81,7348
E02005123,8461,1537,1230,984,393,103,12708
E02005124,6063,1041,768,659,353,77,8961
E02005125,5572,1090,893,640,260,45,8500
E02005126,4705,1081,884,964,482,89,8205
E02005127,4900,1396,1068,988,446,123,8921
E02005128,5007,1226,1002,951,396,69,8651
E02005129,6604,1641,1368,1175,535,131,11454
E02005130,5029,1424,1133,885,392,75,8938
E02005131,3770,1005,819,712,268,45,6619
E02005132,7921,1316,1016,678,385,128,11444
E02005133,3685,1252,1389,1439,681,158,8604
E02005134,5588,1022,724,492,192,33,8051
E02005135,5188,1061,820,631,278,88,8066
E02005136,4300,1158,1080,864,376,82,7860
E02005137,5196,1035,849,699,275,40,8094
E02005138,4871,1308,1204,1178,568,135,9264
E02005139,3225,1202,1555,1688,838,217,8725
E02005140,3408,1109,1069,1263,602,161,7612
E02005141,3593,1057,1126,1009,466,116,7367
E02005142,3750,1043,1054,974,493,82,7396
E02005143,5011,1160,943,775,385,79,8353
E02005144,5843,1123,924,656,289,66,8901
E02005145,3848,1190,1111,986,377,79,7591
E02005146,5526,1099,829,547,191,35,8227
E02005147,5195,1229,1119,825,321,81,8770
E02005148,3457,1121,1215,1182,519,103,7597
E02005149,6671,1694,1205,993,417,64,11044
E02005150,7896,1558,1155,820,374,70,11873
E02005151,7696,1918,1432,1235,483,61,12825
E02005153,5865,1184,1016,971,491,75,9602
E02005154,6882,1842,1397,1135,550,155,11961
E02005155,8644,1870,1084,875,312,41,12826
E02005156,3903,1197,911,815,381,65,7272
E02005157,3984,1001,747,728,406,72,6938
E02005158,3836,1032,791,690,372,87,6808
E02005159,4226,1167,859,936,560,79,7827
E02005160,8662,1543,895,822,523,115,12560
E02005161,5731,1271,792,507,262,68,8631
E02006833,6834,1752,1521,1189,537,153,11986
E02005162,5969,1549,1288,1094,471,115,10486
E02005163,5133,1286,800,670,285,81,8255
E02005164,5560,1173,752,647,300,98,8530
E02005165,4067,1190,1000,898,430,127,7712
E02005166,5058,908,612,447,198,59,7282
E02005167,4269,1235,970,830,423,135,7862
E02005168,4993,1144,721,534,386,129,7907
E02005169,7212,1181,735,493,262,56,9939
E02005170,6493,1398,860,730,530,183,10194
E02005171,4128,877,579,516,264,112,6476
E02005172,4856,1567,1035,854,333,88,8733
E02005173,4926,1333,986,858,459,132,8694
E02005174,4056,1228,963,829,483,120,7679
E02005175,4827,1420,1113,992,511,112,8975
E02005176,5245,1193,998,872,373,81,8762
E02005177,3800,653,607,473,308,103,5944
E02005178,8248,864,652,321,206,24,10315
E02005179,5394,1346,1000,816,321,85,8962
E02005180,3561,1051,927,710,371,81,6701
E02005181,4011,810,701,530,227,52,6331
E02005182,3841,750,645,492,217,80,6025
E02005183,3203,872,771,715,306,63,5930
E02005184,2319,860,802,775,221,45,5022
E02005185,6099,1143,861,591,224,50,8968
E02005186,3272,1045,740,609,181,37,5884
E02006881,6056,1399,1136,995,386,104,10076
E02005189,3490,754,659,450,193,47,5593
E02005190,3209,1073,901,675,248,31,6137
E02005191,5325,1461,1181,977,336,60,9340
E02005192,5693,1449,930,645,244,32,8993
E02005193,4445,1282,1146,1078,342,80,8373
E02005194,4404,1230,974,851,403,74,7936
E02005195,4552,1402,956,784,280,98,8072
E02005196,6763,1178,1145,1102,482,103,10773
E02005197,4748,1015,746,582,220,45,7356
E02005198,6378,1287,927,834,364,57,9847
E02005199,3948,1245,993,1035,399,36,7656
E02005200,6568,1296,764,503,266,42,9439
E02005201,5071,1149,984,789,319,58,8370
E02005202,5695,1546,1297,1196,482,115,10331
E02005203,4080,1272,1147,995,402,56,7952
E02005204,7008,1806,1427,1232,462,83,12018
E02005205,3850,1063,892,796,280,44,6925
E02005206,3798,1138,1032,879,414,87,7348
E02005207,3823,1295,1334,1252,665,124,8493
E02005208,4655,1695,1431,1296,844,264,10185
E02005209,4248,1392,1174,1070,465,67,8416
E02005210,4169,1707,1568,1615,1020,258,10337
E02005211,4211,1524,1288,1247,675,161,9106
E02005212,6517,1546,1235,1118,503,71,10990
E02005213,7008,1608,1249,963,391,121,11340
E02005214,3771,983,708,657,263,42,6424
E02005215,7576,1729,1320,1073,550,124,12372
E02005216,3432,763,565,477,162,14,5413
E02005217,10003,1043,800,569,264,64,12743
E02005218,4420,1039,745,712,321,60,7297
E02005219,4880,1264,1007,856,335,56,8398
E02005220,2985,1039,846,816,328,52,6066
E02005221,4783,1546,1502,1313,596,146,9886
E02005222,2914,1089,951,898,391,77,6320
E02005223,3179,1101,1127,1057,527,149,7140
E02005224,2009,754,787,900,608,181,5239
E02005225,2948,848,756,710,348,56,5666
E02005226,4973,1028,867,622,302,86,7878
E02005228,3608,809,699,524,290,71,6001
E02005229,3794,894,582,405,161,32,5868
E02005230,3789,843,880,798,363,45,6718
E02005231,5398,1121,839,558,216,36,8168
E02005233,5261,961,730,431,178,46,7607
E02005234,7272,773,535,301,186,45,9112
E02005235,4804,504,316,234,149,24,6031
E02005236,8093,1998,1585,1428,568,112,13784
E02005237,7034,1433,1050,798,404,104,10823
E02005238,3709,729,582,501,270,65,5856
E02005239,9019,967,858,724,305,46,11919
E02006871,6763,1775,1473,1239,652,120,12022
E02005240,3207,763,633,489,232,40,5364
E02005241,3130,812,703,602,233,50,5530
E02005242,3380,915,854,672,300,47,6168
E02005243,2777,756,611,467,259,63,4933
E02005244,3793,791,645,472,228,42,5971
E02005245,3475,1176,1045,785,311,62,6854
E02005246,3189,789,590,430,164,46,5208
E02005247,4917,1485,1386,1259,522,102,9671
E02005248,5114,621,627,375,159,31,6927
E02005249,7456,1112,874,580,235,54,10311
E02005250,6566,729,612,351,217,37,8512
E02005251,4453,884,768,682,322,96,7205
E02005252,6153,1058,1038,805,350,54,9458
E02005253,3580,1014,760,704,291,70,6419
E02005254,4070,1187,914,753,342,45,7311
E02005255,5030,1249,996,952,528,99,8854
E02005256,3880,1152,743,464,299,75,6613
E02005257,3698,761,710,511,288,54,6022
E02005258,4566,1055,916,814,470,57,7878
E02005259,6718,1272,999,690,420,73,10172
E02005260,3641,1013,775,680,390,100,6599
E02005261,7269,1258,930,467,259,38,10221
E02005262,4211,1103,614,394,167,25,6514
E02005263,5589,702,454,257,123,17,7142
E02005264,9948,1129,770,487,209,35,12578
E02005265,6873,1466,1062,743,430,90,10664
E02005266,6778,864,556,317,154,25,8694
E02005267,5909,567,407,215,103,16,7217
E02005268,6869,985,754,440,253,32,9333
E02005269,8462,1102,751,376,170,43,10904
E02005270,3351,1384,1183,929,388,50,7285
E02005271,4416,1234,887,805,447,135,7924
E02005272,5234,1173,990,779,422,131,8729
E02005273,2989,989,846,680,319,69,5892
E02005274,3936,1292,938,937,350,79,7532
E02005275,3301,830,724,559,331,62,5807
E02005276,5026,1551,1173,892,411,65,9118
E02005277,3995,1481,1254,1208,539,124,8601
E02005278,4678,1289,1070,712,229,41,8019
E02005279,6743,1443,1041,775,400,80,10482
E02005280,6927,1603,1243,814,341,72,11000
E02005281,5680,1231,987,691,320,71,8980
E02005284,3380,942,755,699,283,87,6146
E02005285,3488,1047,803,672,332,84,6426
E02005286,4629,1257,928,741,279,51,7885
E02006884,7628,1837,1484,1119,397,79,12544
E02005287,2916,864,681,539,303,58,5361
E02005288,3041,1018,839,805,336,94,6133
E02005289,2941,926,901,758,352,53,5931
E02005290,4342,1175,831,593,251,45,7237
E02005291,3324,864,663,547,218,23,5639
E02005292,3539,740,662,525,271,98,5835
E02005293,3086,748,614,626,323,56,5453
E02005294,4412,935,639,509,287,30,6812
E02005295,4344,1148,848,664,301,72,7377
E02005296,2920,937,796,837,399,90,5979
E02005297,4056,1418,1134,1102,555,77,8342
E02005298,4521,1089,940,732,318,49,7649
E02005299,5307,987,656,493,200,51,7694
E02005300,2920,825,727,500,127,17,5116
E02005301,3634,961,759,636,320,79,6389
E02005302,4572,935,829,787,315,77,7515
E02005303,3920,830,744,544,238,50,6326
E02005304,4510,1364,1184,1085,447,84,8674
E02005305,3477,1308,1247,1060,398,97,7587
E02005306,3381,1235,1198,989,412,73,7288
E02005307,5348,1323,1055,996,475,109,9306
E02005308,3262,1131,886,942,379,111,6711
E02005309,4507,1242,1021,933,516,102,8321
E02005310,6289,841,806,751,497,102,9286
E02005311,3655,911,833,741,349,72,6561
E02005312,3256,955,870,544,257,29,5911
E02005313,6169,1114,737,523,201,47,8791
E02005314,3864,935,714,576,279,37,6405
E02005315,3768,1275,1071,1112,640,150,8016
E02005316,4546,883,547,431,198,34,6639
E02005317,5024,934,625,465,164,39,7251
E02005318,4097,1200,947,775,460,80,7559
E02005319,4611,1206,1010,782,356,55,8020
E02005320,3338,876,735,586,371,62,5968
E02005321,3260,800,808,891,413,99,6271
E02005322,4441,1455,1651,1765,829,170,10311
E02005323,4455,1080,916,742,253,63,7509
E02005324,3503,1177,951,774,359,107,6871
E02005325,4270,1305,1389,1481,739,150,9334
E02005326,3790,1377,1249,1229,721,158,8524
E02005327,3070,1161,956,865,344,68,6464
E02005328,3361,1216,1229,1156,572,80,7614
E02005329,5569,1375,1097,963,469,105,9578
E02005330,4513,1394,1312,1275,558,100,9152
E02005331,3948,1150,1087,1018,551,180,7934
E02005332,4053,1400,1228,1106,642,112,8541
E02005334,3762,833,640,470,306,81,6092
E02005335,3907,1166,865,791,490,97,7316
E02005336,5355,888,599,385,203,32,7462
E02005337,6077,1376,1078,853,497,81,9962
E02005338,6705,1568,1122,911,473,104,10883
E02005339,5171,1322,997,797,339,50,8676
E02005340,5039,1275,1071,972,433,117,8907
E02005341,4991,1206,701,593,275,59,7825
E02005342,4066,1092,934,818,300,53,7263
E02005343,4295,1129,1013,857,359,62,7715
E02005344,5104,1164,1039,1006,383,76,8772
E02006820,5888,1563,1320,1105,663,114,10653
E02005345,3978,922,844,644,213,45,6646
E02005346,9810,1367,1004,545,332,80,13138
E02005347,9155,750,642,427,238,63,11275
E02005348,2960,780,857,747,268,56,5668
E02005349,4435,1011,860,739,327,79,7451
E02005350,3697,998,865,702,277,69,6608
E02005351,10837,653,569,461,216,62,12798
E02005352,3466,1086,891,637,306,66,6452
E02005353,7658,1194,896,687,293,50,10778
E02005354,6045,1453,1155,919,628,114,10314
E02005355,4320,1014,892,767,325,67,7385
E02005356,4077,1175,881,796,357,92,7378
E02005357,5609,1186,842,571,270,52,8530
E02005358,7199,1803,1132,959,475,96,11664
E02005359,4088,1004,848,806,312,58,7116
E02005360,3458,1040,927,782,386,99,6692
E02005361,4047,998,800,564,260,70,6739
E02005362,4620,995,790,666,313,52,7436
E02005363,5262,1122,900,869,544,109,8806
E02005364,3207,856,589,438,215,43,5348
E02005365,6047,1430,1259,975,451,104,10266
E02005366,4318,1046,800,768,361,70,7363
E02005368,3067,1216,921,772,327,47,6350
E02005369,7007,1744,1395,1231,630,115,12122
E02005370,5514,1531,1105,751,269,50,9220
E02005371,5527,1758,1322,1136,401,108,10252
E02005372,4844,1921,1414,1055,440,103,9777
E02005373,6406,1700,1418,1268,518,75,11385
E02005374,3942,956,722,631,486,146,6883
E02005375,5895,1329,966,905,469,109,9673
E02005376,5987,1588,1138,1076,477,123,10389
E02006816,4200,1213,1008,781,459,95,7756
E02005377,4826,1321,1099,1010,472,67,8795
E02005378,3064,754,696,537,259,38,5348
E02005379,3536,947,802,683,303,56,6327
E02005380,4524,1468,1299,1152,410,100,8953
E02005381,4542,1270,1257,1076,467,93,8705
E02005382,6539,1509,1251,1022,455,102,10878
E02005383,5407,1348,1068,945,360,110,9238
E02005384,3965,1356,917,745,349,68,7400
E02005385,3457,1018,855,772,316,67,6485
E02005386,5761,1232,841,693,374,129,9030
E02005387,6509,1429,1035,816,268,35,10092
E02005388,3794,853,653,522,265,54,6141
E02005389,3056,820,749,701,423,126,5875
E02005390,5380,1512,1356,1104,448,69,9869
E02005391,4706,1853,1442,1174,448,107,9730
E02005392,5135,1403,1061,948,478,76,9101
E02005393,3723,1285,1025,751,311,75,7170
E02005394,6057,1249,1108,869,366,117,9766
E02005395,4772,1477,1133,922,399,100,8803
E02005396,3031,1273,1032,873,355,75,6639
E02005397,5228,1484,1144,952,321,69,9198
E02005398,3851,956,799,674,290,58,6628
E02005399,5143,1072,887,701,292,65,8160
E02005400,3004,870,868,754,290,57,5843
E02005401,3363,1128,886,693,267,82,6419
E02005402,3680,956,814,788,352,100,6690
E02005403,3682,1050,863,812,375,71,6853
E02005404,4929,1397,1016,745,289,74,8450
E02005405,4050,963,844,763,328,71,7019
E02005406,5550,1143,700,491,207,91,8182
E02005407,6657,1494,958,786,300,42,10237
E02005408,4666,1272,1011,771,262,49,8031
E02005409,7241,1830,1280,1054,420,76,11901
E02005412,4910,1140,1000,863,646,163,8722
E02005414,4830,1074,847,681,524,206,8162
E02005415,5087,1079,749,666,410,64,8055
E02005416,4284,1251,1172,1178,448,83,8416
E02006818,4603,1159,936,778,607,122,8205
E02006911,9867,2102,1520,1154,649,163,15455
E02005417,3487,1289,1193,987,426,86,7468
E02005418,8198,1314,1043,640,369,58,11622
E02005419,6370,1242,724,437,244,80,9097
E02005420,5595,1064,900,806,378,107,8850
E02005422,3236,881,931,810,322,78,6258
E02005423,5667,1309,1382,1131,511,122,10122
E02006864,4766,1187,1097,1029,441,93,8613
E02006865,4610,997,1015,949,467,105,8143
E02005424,4603,1677,1721,1552,539,104,10196
E02005425,2870,1060,1155,927,392,48,6452
E02005426,5889,1396,1238,1106,552,138,10319
E02005427,3840,981,978,800,398,97,7094
E02005428,3224,1340,1592,1466,545,78,8245
E02005429,1743,958,1467,1580,603,92,6443
E02005430,3045,1245,1223,1082,457,99,7151
E02005431,3888,1365,1461,1343,544,109,8710
E02005432,3143,1394,1461,1204,416,76,7694
E02005433,2487,1132,1447,1352,536,69,7023
E02005434,3712,1151,913,997,505,101,7379
E02005435,3484,1060,1174,1122,423,72,7335
E02005436,3946,1158,1325,1173,506,104,8212
E02005437,3261,950,844,564,250,79,5948
E02005438,3647,990,1000,897,441,100,7075
E02005439,6925,1538,1505,1451,761,162,12342
E02005440,2531,850,942,749,304,58,5434
E02005441,3933,1505,1432,1187,531,87,8675
E02005442,3896,857,623,439,235,65,6115
E02005443,4513,940,732,660,355,75,7275
E02005444,7975,1454,1192,951,536,138,12246
E02005445,9155,1292,908,527,215,56,12153
E02005446,9402,570,484,313,148,41,10958
E02005447,5873,710,443,269,196,82,7573
E02005448,4882,871,642,487,185,24,7091
E02005449,6779,983,648,541,254,68,9273
E02005450,4198,1127,1111,889,470,187,7982
E02005451,5271,1001,711,457,251,40,7731
E02005452,6076,1637,1332,1125,622,110,10902
E02005453,5589,1807,1421,1459,640,113,11029
E02005455,8354,2051,1609,1479,591,103,14187
E02005456,6476,1306,1117,1019,583,97,10598
E02005457,4455,1361,1098,1064,493,111,8582
E02005458,3273,1150,917,983,439,75,6837
E02005459,4354,1373,1207,1007,416,69,8426
E02005460,4222,846,662,548,208,25,6511
E02005461,2626,1142,1014,977,460,64,6283
E02005462,5840,1361,1065,945,450,100,9761
E02005463,6115,1497,940,801,357,63,9773
E02005464,3929,1498,1275,1246,508,102,8558
E02006866,5379,1072,772,792,381,95,8491
E02006867,4019,1149,983,1038,609,81,7879
E02005465,4151,1358,1358,1095,500,101,8563
E02005466,3217,1032,986,977,406,67,6685
E02005467,4090,1007,928,858,574,106,7563
E02005468,3738,1271,1095,1008,426,85,7623
E02005469,4455,1219,1060,840,366,105,8045
E02005470,8468,1601,1165,1023,629,153,13039
E02005471,5857,1392,1071,884,476,112,9792
E02005472,4988,1369,1336,1358,673,145,9869
E02005473,6381,1246,1021,981,507,128,10264
E02005474,3090,1205,1061,968,397,72,6793
E02005475,3752,1049,849,776,300,57,6783
E02005476,3480,1347,1055,912,374,52,7220
E02005477,4023,1503,1508,1405,578,95,9112
E02005478,5500,1360,1283,1119,492,172,9926
E02005479,5260,1383,1137,940,425,107,9252
E02005480,5331,882,677,534,188,24,7636
E02005481,8433,1683,1079,892,434,134,12655
E02005482,4971,1624,1537,1090,393,62,9677
E02005483,3930,1413,1124,965,403,97,7932
E02005484,3656,1269,989,892,363,42,7211
E02005485,4283,1033,913,800,383,97,7509
E02005486,5781,1269,1032,959,569,181,9791
E02005487,4674,1748,1467,1239,525,98,9751
E02005488,3628,964,1066,810,366,82,6916
E02005489,3965,1051,1057,776,280,58,7187
E02005490,5558,1282,1051,940,479,102,9412
E02005491,6083,1670,1372,1309,648,155,11237
E02005492,4627,1651,1627,1242,486,115,9748
E02005493,5314,1644,1340,1179,549,118,10144
E02005494,5148,1573,1422,1316,574,125,10158
E02005495,6603,1590,1175,863,378,66,10675
E02005496,3262,1164,1022,790,256,25,6519
E02005497,5205,934,745,612,298,62,7856
E02005498,3093,1256,1243,1227,499,86,7404
E02005499,4591,1326,1145,910,411,62,8445
E02005500,3827,1204,1005,872,346,60,7314
E02005501,3836,1176,1105,1077,522,94,7810
E02005502,4848,1339,1412,1317,570,108,9594
E02005503,3773,1056,1046,962,455,128,7420
E02005504,4157,1475,1451,1294,617,116,9110
E02005505,4103,1041,884,891,505,176,7600
E02005506,3469,1019,1037,908,430,80,6943
E02005507,6746,1582,1345,1372,692,127,11864
E02005508,3343,1157,1061,999,372,75,7007
E02005509,3963,972,1175,1238,716,214,8278
E02005510,3071,1053,1136,1144,484,135,7023
E02005511,4136,1103,1070,1133,649,157,8248
E02005512,5457,1375,1249,978,329,62,9450
E02005513,5647,1393,1092,1073,582,166,9953
E02005514,3317,1138,1063,944,381,60,6903
E02005515,3417,1056,830,698,346,77,6424
E02005516,3438,1064,1052,912,356,86,6908
E02005517,4619,808,553,352,166,35,6533
E02005518,7287,1499,1101,909,492,103,11391
E02005519,5985,1135,809,571,354,59,8913
E02005520,4280,1225,1194,1250,586,122,8657
E02005521,4433,1439,1271,1122,419,97,8781
E02005522,2849,857,757,691,313,67,5534
E02005523,4909,1349,1035,823,299,55,8470
E02005524,2736,860,816,708,323,44,5487
E02005525,5840,1547,1145,1040,474,118,10164
E02005526,2955,767,605,546,401,74,5348
E02005527,4866,1275,1072,1030,557,122,8922
E02005528,4721,1126,1064,1031,542,113,8597
E02005529,2690,881,786,833,561,153,5904
E02005530,2848,829,682,670,388,66,5483
E02005531,2943,824,684,620,292,84,5447
E02005532,4244,1137,1046,1086,675,94,8282
E02005533,4481,1354,1252,1212,520,98,8917
E02005534,3650,1148,989,865,492,137,7281
E02005535,4424,1057,790,567,323,82,7243
E02005536,3035,999,891,828,380,83,6216
E02005537,3024,898,817,794,421,96,6050
E02005538,3665,1476,1690,1508,569,160,9068
E02005539,3508,1225,1247,1052,425,77,7534
E02005540,3941,1317,1369,1502,730,136,8995
E02005541,3273,807,712,691,355,86,5924
E02005542,4877,1025,810,575,220,47,7554
E02005543,6776,1243,837,563,210,78,9707
E02005544,5078,983,694,480,225,37,7497
E02005545,3145,868,886,987,387,78,6351
E02005546,4724,1028,908,794,349,89,7892
E02005547,4995,1175,1051,981,493,117,8812
E02005548,4460,947,789,720,436,146,7498
E02005549,2382,853,885,789,294,67,5270
E02005550,3796,1088,913,907,438,92,7234
E02005551,1741,704,970,1074,589,168,5246
E02005552,2698,1064,1225,1178,516,109,6790
E02005553,3023,1280,1527,1834,787,181,8632
E02005554,2788,978,1125,1287,603,124,6905
E02005555,3329,967,1047,915,473,116,6847
E02005556,4208,1068,916,751,388,77,7408
E02005557,4695,819,539,394,165,43,6655
E02005558,3555,1063,1015,941,460,53,7087
E02005559,4460,1018,801,573,330,84,7266
E02005560,6519,1058,737,588,268,34,9204
E02005561,7544,1360,1019,817,388,85,11213
E02005562,3303,1236,1093,1038,412,68,7150
E02005563,3837,1230,1086,927,389,82,7551
E02005564,5743,1268,1232,1097,488,102,9930
E02005565,3749,1082,915,843,349,58,6996
E02005566,4892,1699,1428,1176,570,82,9847
E02005567,5705,1300,1297,1504,970,229,11005
E02005568,3513,1214,1150,1008,481,57,7423
E02005569,4636,1268,1080,851,339,54,8228
E02005570,2889,937,1230,1314,783,212,7365
E02005571,2349,866,1089,1006,574,106,5990
E02005572,3310,1055,1264,1233,634,242,7738
E02005573,2356,674,965,1096,636,147,5874
E02005574,2763,1266,1282,1183,510,113,7117
E02005575,3034,1192,1306,1076,469,92,7169
E02005576,2617,1016,1209,1200,545,143,6730
E02005577,2900,936,990,841,348,69,6084
E02005578,2967,973,833,718,314,38,5843
E02005579,6492,1760,1672,1693,1032,252,12901
E02005580,3949,1047,1100,1077,612,152,7937
E02005581,4062,1398,1393,1058,379,72,8362
E02005582,3289,1049,1139,945,472,97,6991
E02005583,3322,1261,1624,1568,789,172,8736
E02005584,7496,1331,960,724,351,93,10955
E02005585,7973,1245,808,651,285,55,11017
E02005586,7428,1073,705,480,167,36,9889
E02005587,6334,1243,895,800,585,128,9985
E02005588,8890,1173,969,669,276,77,12054
E02005589,8690,1249,828,649,355,70,11841
E02005590,7489,1169,1012,837,432,147,11086
E02005592,6814,1017,797,525,180,61,9394
E02005593,10301,730,551,430,314,88,12414
E02005594,7291,1251,1129,884,421,129,11105
E02005595,4572,1195,1087,1169,711,218,8952
E02005596,6044,1107,853,770,455,141,9370
E02006907,4923,682,488,414,208,81,6796
E02006908,3865,685,572,375,182,36,5715
E02005597,10924,1993,1530,1374,695,144,16660
E02005598,6078,1265,1048,963,499,124,9977
E02005599,3712,807,775,781,400,94,6569
E02005600,3704,956,829,758,316,72,6635
E02005601,2715,915,715,826,416,86,5673
E02005602,6448,1879,1591,1427,790,150,12285
E02005603,7550,1589,1095,931,408,79,11652
E02005604,4331,1340,1202,1053,552,122,8600
E02005605,5879,1592,1437,1236,499,134,10777
E02005606,2912,982,896,700,326,32,5848
E02005607,6211,1806,1545,1325,566,108,11561
E02005608,3661,1238,1176,1072,499,110,7756
E02005609,3903,977,976,1035,538,97,7526
E02005610,3844,1333,1304,1119,460,102,8162
E02005611,6181,1526,1270,1270,744,208,11199
E02005612,4287,1162,918,631,248,72,7318
E02005613,6058,1381,978,641,304,61,9423
E02005614,7600,1536,1031,637,295,55,11154
E02005615,5387,1332,1060,837,436,58,9110
E02005616,3721,874,510,386,193,15,5699
E02005617,7540,1377,986,654,282,43,10882
E02006862,3924,962,887,533,174,26,6506
E02006863,9663,1305,662,354,106,36,12126
E02005619,3093,1153,886,658,297,66,6153
E02005620,5152,1466,1138,823,293,85,8957
E02005621,4638,1440,1237,1033,414,60,8822
E02005622,5093,1638,1300,1011,374,61,9477
E02005623,5466,1535,1227,1031,455,121,9835
E02005624,7338,1632,981,757,263,35,11006
E02005625,5694,1254,999,952,491,123,9513
E02005626,4623,922,708,438,128,12,6831
E02005627,3970,1129,1059,869,386,71,7484
E02005628,4115,1405,1081,876,326,69,7872
E02005629,3161,1151,935,805,302,71,6425
E02005630,5689,1716,1368,1161,575,125,10634
E02005631,6010,1792,1281,1016,403,104,10606
E02005632,3412,1047,974,777,324,98,6632
E02005633,5139,1388,1157,965,406,110,9165
E02005634,5814,1342,1009,763,325,85,9338
E02005635,5823,1387,1024,894,395,86,9609
E02005636,7552,1653,1337,1106,463,123,12234
E02005637,6212,1273,930,679,388,114,9596
E02005638,5704,1650,1272,1148,436,78,10288
E02005639,2276,972,829,714,272,72,5135
E02005640,6988,1606,1301,1111,393,121,11520
E02005641,4842,1078,1116,835,278,64,8213
E02005642,4843,1283,892,779,356,62,8215
E02005643,5902,1108,735,490,213,30,8478
E02005644,6812,1048,723,378,139,38,9138
E02005645,7924,1492,1080,952,626,212,12286
E02005646,3504,924,806,871,314,54,6473
E02005647,4713,1140,732,669,361,86,7701
E02005648,5003,1229,898,905,373,50,8458
E02005649,10332,2307,1584,1321,504,111,16159
E02005650,4142,733,749,648,217,60,6549
E02005651,2868,922,908,795,381,83,5957
E02005652,3155,817,782,832,386,69,6041
E02005653,6222,992,728,450,117,18,8527
E02005654,5959,970,780,420,140,11,8280
E02005655,3193,851,799,730,402,74,6049
E02005656,4229,702,618,348,111,12,6020
E02005657,3383,817,793,645,304,48,5990
E02005658,4811,702,479,315,147,25,6479
E02005659,3287,707,654,557,345,85,5635
E02005660,3872,829,737,580,149,23,6190
E02005661,4827,919,528,322,165,33,6794
E02005662,4049,1015,580,534,302,68,6548
E02005663,3012,788,684,542,222,35,5283
E02005664,3941,803,477,392,226,85,5924
E02005665,4847,1123,937,578,221,37,7743
E02005666,6300,968,577,366,182,44,8437
E02005667,3992,906,723,672,327,72,6692
E02005668,3278,842,743,717,429,138,6147
E02005669,2939,932,772,674,323,107,5747
E02005670,7932,999,538,256,133,26,9884
E02005671,5563,846,585,314,210,69,7587
E02005672,7065,772,391,186,77,16,8507
E02005673,4848,841,670,490,284,88,7221
E02005674,6639,945,703,410,281,92,9070
E02005675,4296,736,500,308,133,26,5999
E02005676,4049,822,511,412,177,24,5995
E02005677,6480,1040,742,509,240,51,9062
E02005678,9723,1508,1029,756,333,101,13450
E02005679,5497,1290,886,498,252,44,8467
E02005680,5668,1361,595,443,208,61,8336
E02005681,4481,1310,1142,1106,398,78,8515
E02005682,3692,1127,959,819,326,54,6977
E02005683,9410,2095,1435,1225,496,114,14775
E02005684,4807,1435,1245,983,369,84,8923
E02005685,5385,1297,1046,792,344,94,8958
E02005686,4105,1417,1002,947,397,96,7964
E02005687,3562,1193,840,650,282,56,6583
E02005688,5801,1470,1107,883,351,43,9655
E02005689,6211,1516,856,666,328,81,9658
E02005690,3339,925,601,502,218,72,5657
E02005691,3632,1142,838,841,325,47,6825
E02005692,3380,1121,915,869,304,67,6656
E02005693,5805,1125,823,651,321,47,8772
E02005694,4036,1134,1105,796,250,37,7358
E02005695,6579,994,730,463,245,69,9080
E02005696,4244,793,484,492,197,40,6250
E02005697,4404,936,729,572,360,116,7117
E02005698,3508,853,686,577,248,47,5919
E02005699,5692,1125,751,513,208,37,8326
E02005700,4769,1427,1343,1165,463,88,9255
E02005701,5922,1693,1469,1313,485,92,10974
E02005742,3364,1232,1218,1059,453,113,7439
E02005743,1923,917,887,794,432,108,5061
E02005744,3440,1355,1300,1180,573,122,7970
E02005745,2435,893,803,761,322,87,5301
E02005746,3571,980,976,756,384,94,6761
E02005747,4254,895,796,579,298,97,6919
E02005748,3870,1329,1135,802,367,99,7602
E02005749,5216,1534,1324,1217,638,160,10089
E02005750,3541,1339,1100,1079,557,103,7719
E02005751,3431,1565,1402,1538,648,80,8664
E02005752,3134,1114,1113,907,330,51,6649
E02005753,7597,1956,1606,1380,761,186,13486
E02005754,3254,1269,1282,1111,558,100,7574
E02005755,3363,1227,908,785,439,106,6828
E02005756,4042,977,914,697,255,28,6913
E02005757,4447,1401,1183,989,537,133,8690
E02005758,4965,1377,1183,992,473,96,9086
E02005759,4363,1534,1347,1213,650,125,9232
E02005760,3752,1237,820,628,275,41,6753
E02005761,2655,909,865,716,291,58,5494
E02005762,3512,843,650,646,389,111,6151
E02005763,3434,993,812,804,299,77,6419
E02005764,5447,1527,1271,1213,637,158,10253
E02005765,3120,1164,963,838,419,106,6610
E02005766,2739,1130,993,775,347,73,6057
E02005767,3395,1295,991,873,419,105,7078
E02005768,4270,957,790,596,280,67,6960
E02005769,3619,1102,894,775,439,108,6937
E02005770,4888,1444,1115,976,533,73,9029
E02005771,4633,1117,849,586,256,48,7489
E02005772,2611,972,953,835,391,77,5839
E02005773,5627,1343,916,647,335,112,8980
E02005774,5383,1420,1030,787,512,160,9292
E02005775,5874,1486,1032,777,471,135,9775
E02005776,5676,1560,1128,909,342,109,9724
E02005777,4471,1304,1073,890,548,135,8421
E02005778,2787,1173,860,752,344,43,5959
E02005779,4010,1215,897,818,568,219,7727
E02005780,5634,1690,1276,1162,743,235,10740
E02005781,2815,935,853,781,398,115,5897
E02005782,3230,1458,1353,1036,490,61,7628
E02005783,3986,1410,1296,1029,543,114,8378
E02005784,3546,931,717,623,314,57,6188
E02005785,13846,1413,835,553,233,76,16956
E02005786,2401,1119,1087,932,354,74,5967
E02005787,3857,1464,1437,1219,541,95,8613
E02005788,2931,1073,1121,940,423,72,6560
E02005789,4709,1596,1788,1619,798,206,10716
E02005790,3215,1169,1072,843,502,93,6894
E02005791,3570,1246,1033,802,263,58,6972
E02005794,4565,1747,1544,1258,546,93,9753
E02006870,8386,2059,1673,1378,799,190,14485
E02005795,3195,1117,1118,892,533,100,6955
E02005796,2814,1163,1219,910,389,90,6585
E02005797,3188,1030,960,723,251,36,6188
E02005798,3360,1419,1464,1373,580,102,8298
E02005799,4230,1321,1342,1403,750,147,9193
E02005800,4479,1210,1043,691,304,53,7780
E02005801,3224,788,609,562,274,71,5528
E02005802,5227,1062,815,560,250,51,7965
E02005803,4743,1341,1295,999,595,217,9190
E02005804,3835,1271,1276,948,567,184,8081
E02005805,3354,1116,1131,1185,533,79,7398
E02005806,4772,1048,775,672,296,47,7610
E02005807,2980,965,1032,927,417,65,6386
E02005808,4774,1712,2033,2061,896,124,11600
E02005809,4034,1305,943,830,362,85,7559
E02005810,5439,1606,1157,852,378,46,9478
E02005811,5297,1513,1327,991,412,91,9631
E02005812,6727,1565,1126,833,378,71,10700
E02005813,9411,1648,1097,733,417,149,13455
E02005814,3444,969,859,823,440,74,6609
E02005815,4400,1357,1245,997,428,44,8471
E02005816,4811,1495,1142,891,305,63,8707
E02005817,4019,1182,1007,788,312,47,7355
E02005818,4713,1444,1170,885,367,76,8655
E02005819,3560,999,878,718,304,38,6497
E02005820,2853,899,706,765,266,34,5523
E02005821,4494,928,745,605,202,33,7007
E02005822,7376,1343,1004,582,300,83,10688
E02005823,4989,1104,732,614,378,140,7957
E02005824,5917,1605,1150,942,388,45,10047
E02005825,4800,1126,906,785,381,48,8046
E02005826,4187,811,648,440,237,53,6376
E02005827,5719,1512,1042,724,374,75,9446
E02005828,4410,1241,1018,931,303,60,7963
E02005829,3698,1020,850,780,320,62,6730
E02005830,2979,1025,843,786,300,41,5974
E02005831,6591,1475,1029,836,401,68,10400
E02005832,6137,1269,873,691,337,68,9375
E02005833,4235,1215,1018,872,331,57,7728
E02005834,5257,1061,778,691,321,53,8161
E02005835,6178,1626,1273,1083,553,72,10785
E02005836,4468,1559,1375,1215,515,95,9227
E02005837,4182,1300,1165,906,335,58,7946
E02005838,4349,1211,1209,1013,401,74,8257
E02005839,3264,938,865,760,458,83,6368
E02005840,5878,1501,951,650,260,55,9295
E02005842,4806,1327,1043,935,495,117,8723
E02005843,4223,1091,699,493,227,79,6812
E02005844,5209,1238,948,776,335,64,8570
E02005846,5076,918,630,384,214,51,7273
E02005847,4160,1022,849,744,321,76,7172
E02005848,3305,1056,886,789,337,47,6420
E02005849,4800,1557,1348,1226,378,85,9394
E02006903,5837,1674,1523,1363,674,146,11217
E02005850,3683,1060,1042,855,339,80,7059
E02005851,3734,869,779,564,268,67,6281
E02005852,4312,1257,1095,1176,490,69,8399
E02005853,5071,1489,1230,987,395,64,9236
E02005856,3731,1038,1032,922,488,123,7334
E02005857,4114,818,597,610,305,27,6471
E02005858,5668,980,729,560,267,51,8255
E02005859,5646,1403,983,828,355,80,9295
E02005860,6535,870,755,656,395,114,9325
E02005861,3615,777,563,453,192,36,5636
E02005862,5049,1070,794,837,399,74,8223
E02005863,4157,1075,925,818,488,133,7596
E02005864,4882,1299,956,693,355,82,8267
E02006906,7021,1994,1567,1322,572,180,12656
E02005865,4087,1301,1106,1164,541,94,8293
E02005866,5106,1386,1276,1107,482,59,9416
E02005868,4174,1053,809,751,325,47,7159
E02005869,3947,800,599,422,251,70,6089
E02005870,4420,971,633,464,315,65,6868
E02005871,3818,1048,999,865,380,37,7147
E02005872,3130,943,831,821,423,72,6220
E02005873,5367,1579,1311,1115,579,99,10050
E02005874,5036,1330,1071,793,420,65,8715
E02005875,4963,1154,808,692,350,67,8034
E02005876,5154,1338,1013,858,480,119,8962
E02005877,4496,989,752,515,298,57,7107
E02005878,5986,1510,1288,845,466,60,10155
E02005879,5310,1050,614,458,171,27,7630
E02006835,3579,969,752,499,229,23,6051
E02005880,3738,943,730,611,334,32,6388
E02005881,3619,914,820,532,289,91,6265
E02005882,3861,1181,1101,998,358,59,7558
E02005883,5342,1240,922,657,277,79,8517
E02005884,3262,957,824,588,246,49,5926
E02005885,4586,1229,1117,856,421,88,8297
E02005886,6699,1622,1373,1010,474,67,11245
E02005887,7355,1266,866,605,403,89,10584
E02005888,5729,1173,824,512,230,45,8513
E02005889,6247,1539,1266,924,430,101,10507
E02005890,3582,1147,882,773,272,49,6705
E02005891,4135,956,692,462,200,53,6498
E02005892,7139,1810,1410,1205,613,133,12310
E02005893,6643,1644,1324,982,453,70,11116
E02005894,6481,1603,1229,986,449,120,10868
E02005895,3633,1394,1308,1125,449,71,7980
E02005896,3456,1200,1137,1184,482,94,7553
E02005897,4918,1536,1266,1103,503,78,9404
E02005898,6732,1818,1295,912,418,91,11266
E02005899,8474,1486,1248,831,345,81,12465
E02005900,3604,1049,979,1105,538,112,7387
E02005901,6207,1303,1054,816,319,114,9813
E02005902,4818,1179,1060,811,395,79,8342
E02005903,5461,1543,1285,1208,521,78,10096
E02005904,5094,1486,1169,988,465,129,9331
E02005905,3387,1200,928,812,409,64,6800
E02005906,3722,1312,1069,816,421,99,7439
E02005907,6199,1324,1095,1017,477,85,10197
E02005908,4894,1346,1189,1165,657,167,9418
E02005909,5767,1133,845,473,256,58,8532
E02005910,7252,955,673,394,267,110,9651
E02005911,5413,1381,925,640,299,72,8730
E02005912,5624,1374,1064,791,501,133,9487
E02005913,4629,1183,861,698,412,127,7910
E02005914,5082,1154,824,675,306,72,8113
E02005915,2784,1001,877,753,248,67,5730
E02005916,4769,1068,844,716,365,94,7856
E02005917,2580,973,764,901,468,109,5795
E02005918,2595,744,678,725,372,54,5168
E02005919,4121,1050,712,665,294,47,6889
E02005920,4352,1267,1067,1062,420,101,8269
E02005921,2721,1061,903,667,332,68,5752
E02005922,5667,1185,702,496,171,20,8241
E02005923,3981,746,481,384,256,33,5881
E02005924,8595,1361,880,539,373,115,11863
E02005925,5826,1063,719,589,225,30,8452
E02005926,4457,1200,1017,1030,565,131,8400
E02005927,2915,730,593,560,234,48,5080
E02005928,5752,1325,1007,1035,472,136,9727
E02005929,3482,1256,960,862,342,66,6968
E02005930,4739,1340,1045,895,378,80,8477
E02005931,6588,1466,996,676,338,94,10158
E02005932,4632,970,542,317,86,7,6554
E02005933,4649,1076,792,548,250,41,7356
E02005934,5217,1312,1037,793,373,78,8810
E02005935,5507,1030,600,410,280,74,7901
E02005936,7452,1725,1222,949,409,90,11847
E02005937,3643,955,850,749,507,114,6818
E02005938,3332,749,685,406,323,53,5548
E02005939,3802,992,814,580,392,90,6670
E02005940,3085,844,683,576,342,75,5605
E02005941,4582,784,673,557,306,113,7015
E02005942,4411,732,581,543,224,89,6580
E02005943,3874,782,560,517,333,76,6142
E02005944,4834,852,570,431,192,52,6931
E02005945,12068,990,773,617,376,149,14973
E02005946,4810,932,790,585,275,59,7451
E02005947,16605,597,477,316,144,50,18189
E02005948,5269,662,510,395,123,36,6995
E02005949,5564,567,473,299,197,46,7146
E02005950,8602,705,641,471,137,47,10603
E02005951,3834,601,482,345,209,53,5524
E02005952,10152,1360,942,580,338,59,13431
E02005953,3574,564,456,254,126,16,4990
E02005954,5906,1188,858,627,390,192,9161
E02005955,6905,1208,796,513,294,67,9783
E02005956,3741,879,513,338,216,35,5722
E02005957,4537,829,429,239,148,34,6216
E02005958,3086,823,700,459,216,44,5328
E02005959,2916,1004,779,644,273,51,5667
E02005960,4314,947,687,751,430,98,7227
E02005961,3578,1063,850,729,376,76,6672
E02005962,4985,1393,1215,1001,408,76,9078
E02005963,4404,1274,1083,844,393,80,8078
E02005964,3576,1239,929,833,414,70,7061
E02005965,2829,909,696,666,296,60,5456
E02005966,5719,1222,543,264,87,18,7853
E02005967,6236,957,600,542,284,66,8685
E02005968,5246,944,669,688,324,66,7937
E02005969,5525,1289,1013,920,553,132,9432
E02005970,3683,773,528,261,127,19,5391
E02005971,3719,914,622,525,324,72,6176
E02005972,6022,1352,1019,949,473,105,9920
E02005973,2949,791,606,730,459,109,5644
E02005974,3532,948,622,661,365,91,6219
E02005975,4231,1319,1029,1006,443,116,8144
E02005976,3103,1090,785,768,362,95,6203
E02005977,2924,956,733,685,461,127,5886
E02005978,4126,1128,964,768,476,175,7637
E02005979,6080,1415,1053,880,564,131,10123
E02005980,7478,1505,1249,1140,546,109,12027
E02005981,5221,1363,1185,810,267,55,8901
E02005982,3638,809,650,582,274,42,5995
E02005983,7684,1400,993,861,542,164,11644
E02005984,4678,1382,1082,851,359,70,8422
E02005985,4786,1084,864,832,375,70,8011
E02005986,6000,1426,1045,892,446,100,9909
E02005987,5808,1341,1035,824,426,70,9504
E02005988,4778,1089,872,743,324,57,7863
E02005991,5610,1449,1102,1003,576,165,9905
E02005992,7974,1673,1317,1123,608,128,12823
E02006886,7864,1999,1410,1250,562,158,13243
E02005993,3916,948,822,805,361,66,6918
E02005994,3528,1019,820,663,357,122,6509
E02005995,2887,1015,907,760,352,100,6021
E02005996,4572,1270,1069,931,534,117,8493
E02005997,2721,851,930,677,323,71,5573
E02005998,3286,914,814,811,369,97,6291
E02005999,3103,1120,901,740,366,65,6295
E02006000,7361,1769,1185,1028,477,158,11978
E02006001,3970,890,561,427,297,81,6226
E02006002,6399,1392,1104,1038,658,182,10773
E02006003,2911,887,663,659,309,60,5489
E02006004,2956,1084,899,754,297,111,6101
E02006005,7520,1035,599,431,199,37,9821
E02006006,4764,883,654,500,272,44,7117
E02006007,3719,1111,948,781,386,93,7038
E02006047,4375,1502,1265,1043,409,78,8672
E02006048,3781,1149,1045,761,309,73,7118
E02006049,3836,1070,1062,951,400,90,7409
E02006050,5531,1266,983,653,365,123,8921
E02006051,3973,1239,1181,1087,556,105,8141
E02006052,3947,1295,1070,917,434,150,7813
E02006053,6632,1451,1151,802,362,96,10494
E02006054,3977,1282,1181,1067,704,198,8409
E02006055,5826,1325,968,737,335,65,9256
E02006056,3943,1323,1058,935,377,87,7723
E02006057,3953,1340,1152,857,359,124,7785
E02006058,5054,1192,1076,932,439,84,8777
E02006059,3048,1273,1131,917,336,88,6793
E02006060,4928,1164,825,801,434,124,8276
E02006061,4640,1542,1261,1103,526,160,9232
E02006062,5121,1754,1762,1608,736,178,11159
E02006063,3090,1276,1107,973,376,78,6900
E02006064,3212,1141,1177,1221,686,219,7656
E02006065,4941,1294,1105,1037,395,89,8861
E02006066,4064,1264,1329,1119,440,90,8306
E02006067,3138,1158,1145,940,424,104,6909
E02006068,5302,1052,733,561,245,63,7956
E02006069,6965,1315,968,674,349,90,10361
E02006070,5161,1163,906,670,316,75,8291
E02006071,5626,1371,1076,894,527,116,9610
E02006072,4126,1760,1572,1297,565,118,9438
E02006073,4799,1014,732,584,262,87,7478
E02006074,6689,1621,1187,966,438,120,11021
E02006075,3135,894,692,587,255,53,5616
E02006076,3839,1470,1409,1207,611,162,8698
E02006077,2650,825,838,829,405,92,5639
E02006078,2793,951,998,861,381,122,6106
E02006079,4206,1165,1108,889,415,94,7877
E02006080,4488,919,771,694,321,58,7251
E02006081,2449,883,903,776,305,49,5365
E02006082,3349,984,1041,900,304,57,6635
E02006083,2700,845,875,781,325,79,5605
E02006084,3326,1123,1304,1079,494,124,7450
E02006085,4357,934,906,767,298,57,7319
E02006086,4459,1003,720,683,361,83,7309
E02006087,4121,748,577,447,254,72,6219
E02006088,5172,999,775,595,331,62,7934
E02006089,4669,877,695,436,260,90,7027
E02006090,4245,912,734,630,321,112,6954
E02006091,4549,1539,1588,1374,536,141,9727
E02006092,3364,961,889,755,304,78,6351
E02006093,4384,1272,1159,1191,609,194,8809
E02006094,2455,865,773,739,387,65,5284
E02006095,3962,1171,1149,1092,544,107,8025
E02006096,3893,1086,805,804,344,69,7001
E02006097,3868,936,779,727,456,106,6872
E02006098,2970,1220,1328,1165,471,118,7272
E02006118,3821,1150,1037,1010,410,53,7481
E02006119,5070,1227,878,661,343,128,8307
E02006120,5758,1350,1012,829,422,76,9447
E02006121,3548,936,680,506,164,33,5867
E02006122,4965,1085,853,617,257,32,7809
E02006123,3914,1070,783,453,193,60,6473
E02006124,4767,1072,824,576,270,70,7579
E02006125,4576,1006,807,750,248,52,7439
E02006126,4867,1266,945,762,334,70,8244
E02006127,5067,1227,742,326,147,50,7559
E02006128,4328,1334,1123,1124,553,116,8578
E02006129,5561,1078,768,650,356,84,8497
E02006130,4253,1193,868,792,318,58,7482
E02006131,3856,1344,1108,920,383,77,7688
E02006132,3904,951,783,588,261,65,6552
E02006133,3980,1134,764,628,346,63,6915
E02006134,4928,1553,1271,1204,565,85,9606
E02006135,3822,1310,1038,871,439,65,7545
E02006136,4321,1492,1175,1154,448,133,8723
E02006137,5854,1187,884,705,433,89,9152
E02006138,5652,842,547,324,142,33,7540
E02006139,6182,836,683,413,185,59,8358
E02006140,5159,1215,975,796,367,79,8591
E02006141,9375,1206,806,478,276,43,12184
E02006142,2581,928,704,591,252,37,5093
E02006143,4817,1192,831,668,273,57,7838
E02006144,4770,1153,935,668,350,96,7972
E02006145,3049,969,833,737,345,64,5997
E02006146,4922,1268,1060,937,340,92,8619
E02006147,4528,1318,1009,899,384,52,8190
E02006148,3344,1197,1001,1039,333,46,6960
E02006149,6907,1435,1134,1003,665,154,11298
E02006150,5659,1655,1704,1566,683,155,11422
E02006151,5390,1357,1101,1024,355,78,9305
E02006152,6074,1442,1024,1146,523,89,10298
E02006153,4314,1241,953,859,352,69,7788
E02006154,4636,1480,1257,1711,594,91,9769
E02006155,3747,797,555,505,187,33,5824
E02006156,3674,1273,1058,1148,555,166,7874
E02006157,4472,1009,845,705,309,69,7409
E02006158,4249,1379,1101,982,293,44,8048
E02006159,3388,744,725,576,281,53,5767
E02006160,5087,1144,1081,950,371,80,8713
E02006161,3726,1211,886,752,309,45,6929
E02006162,4735,1325,1113,919,376,81,8549
E02006163,5215,1096,840,682,388,79,8300
E02006164,5247,987,815,492,347,82,7970
E02006165,5075,1068,744,679,357,60,7983
E02006166,4037,1107,843,730,347,74,7138
E02006167,7032,1178,892,692,384,71,10249
E02006168,6162,1037,843,645,456,153,9296
E02006169,7524,692,622,492,221,44,9595
E02006170,2750,826,731,655,316,64,5342
E02006171,5288,1258,1022,935,541,120,9164
E02006172,4710,1479,1300,1157,655,113,9414
E02006173,3201,1181,1122,975,415,90,6984
E02006174,5387,1579,1441,1412,570,78,10467
E02006175,4495,1189,732,603,221,44,7284
E02006176,3769,1227,1091,1031,477,80,7675
E02006177,5304,1477,1317,1217,500,71,9886
E02006178,4205,1292,957,978,349,46,7827
E02006179,5587,1439,1027,906,354,45,9358
E02006180,3774,1114,850,668,437,109,6952
E02006181,3123,792,710,634,387,76,5722
E02006182,3539,1108,867,945,486,108,7053
E02006183,3875,1254,1170,791,370,65,7525
E02006184,3123,712,789,463,141,53,5281
E02006185,3857,1141,913,839,491,100,7341
E02006186,6220,2205,1747,1546,937,186,12841
E02006187,3146,1261,1076,1139,491,111,7224
E02006188,2979,914,828,809,417,106,6053
E02006189,3453,1241,1147,959,496,122,7418
E02006190,6306,1587,1158,1002,622,161,10836
E02006191,4110,1320,1196,1024,353,77,8080
E02006192,4607,1540,1230,1052,452,53,8934
E02006193,3826,997,830,849,387,51,6940
E02006194,5262,1143,803,681,441,109,8439
E02006195,4185,1408,1367,1240,461,81,8742
E02006196,5434,899,668,444,190,39,7674
E02006197,6922,1096,662,552,304,88,9624
E02006198,5731,1285,1003,810,392,73,9294
E02006199,4041,1415,1050,983,459,143,8091
E02006200,5093,1061,807,619,282,69,7931
E02006201,6326,1795,1481,1619,776,124,12121
E02006202,4373,1600,1408,1242,482,65,9170
E02006203,4951,1093,861,706,262,60,7933
E02006204,4280,1134,990,788,357,72,7621
E02006205,3429,1259,1207,1128,399,74,7496
E02006206,5416,1294,844,501,337,81,8473
E02006207,2770,988,969,1030,418,61,6236
E02006208,5004,1227,910,710,319,100,8270
E02006209,5648,1713,1505,1363,639,127,10995
E02006210,2515,1004,921,719,288,49,5496
E02006211,3075,1047,886,906,480,94,6488
E02006212,3861,1171,1130,1057,553,81,7853
E02006213,3413,1143,874,773,317,44,6564
E02006214,3407,901,815,800,313,51,6287
E02006215,3906,1367,1099,1063,446,66,7947
E02006216,4630,1338,1145,1130,390,76,8709
E02006217,4896,1247,1150,1210,559,124,9186
E02006218,4930,1071,840,820,504,121,8286
E02006219,4675,1108,939,677,197,33,7629
E02006220,4178,1084,858,890,351,59,7420
E02006221,3806,986,626,463,138,15,6034
E02006222,4386,873,785,621,221,32,6918
E02006223,5050,729,607,451,135,27,6999
E02006224,4671,1195,941,479,173,15,7474
E02006225,4040,1028,989,753,309,53,7172
E02006226,6394,1242,1024,617,253,48,9578
E02006227,2573,1110,1111,942,429,105,6270
E02006228,3216,911,901,743,284,66,6121
E02006229,2790,862,892,907,391,95,5937
E02006230,5965,1530,1419,1306,746,182,11148
E02006231,4855,1326,1108,854,375,101,8619
E02006232,3041,966,905,787,337,71,6107
E02006233,6492,1689,1316,1334,743,216,11790
E02006234,5989,1394,923,1003,364,78,9751
E02006235,3863,1368,1221,1097,522,129,8200
E02006236,4998,1632,1456,1487,686,103,10362
E02006237,3814,1281,1080,931,480,145,7731
E02006245,4620,1026,866,749,429,88,7778
E02006246,3807,1003,963,741,428,98,7040
E02006247,6160,1097,793,582,234,49,8915
E02006248,5018,1083,836,708,384,80,8109
E02006249,4741,1158,997,715,456,118,8185
E02006250,8209,1212,834,443,187,60,10945
E02006251,8190,1284,787,413,200,54,10928
E02006252,6248,1098,843,585,376,119,9269
E02006253,3433,990,958,835,519,160,6895
E02006254,6529,1168,848,534,294,126,9499
E02006255,5685,1052,714,467,237,53,8208
E02006256,6889,1116,856,548,257,88,9754
E02006257,3582,903,796,646,448,85,6460
E02006258,6129,1156,915,545,270,67,9082
E02006259,4365,834,842,694,289,76,7100
E02006260,5709,1058,946,622,352,59,8746
E02006261,3744,1294,1249,1210,473,100,8070
E02006262,4294,1568,1423,1238,492,103,9118
E02006263,3529,1302,1192,1152,471,66,7712
E02006264,4647,1402,1139,947,456,81,8672
E02006265,3593,1187,1074,934,408,87,7283
E02006266,4712,1528,1448,1303,559,103,9653
E02006267,4277,1511,1359,945,457,66,8615
E02006268,3601,834,799,710,365,98,6407
E02006269,4033,1207,961,773,378,156,7508
E02006270,9108,1783,1199,850,402,125,13467
E02006271,5917,1192,1105,1008,426,100,9748
E02006272,3840,1183,1049,991,477,102,7642
E02006317,3430,814,706,565,267,64,5846
E02006318,3643,1086,750,616,270,100,6465
E02006319,4238,971,706,514,273,83,6785
E02006320,4557,913,599,430,210,20,6729
E02006321,4021,945,597,493,271,132,6459
E02006322,4174,1036,637,428,241,39,6555
E02006323,4562,990,699,600,410,83,7344
E02006324,5191,1116,643,449,252,96,7747
E02006325,5965,1494,840,700,400,105,9504
E02006326,4421,934,630,553,289,77,6904
E02006327,3932,998,648,631,350,91,6650
E02006328,5854,1336,925,695,397,137,9344
E02006329,4365,1184,780,670,350,142,7491
E02006330,5886,1314,936,916,498,174,9724
E02006331,3944,1191,816,656,365,79,7051
E02006332,3779,1022,674,501,317,133,6426
E02006333,6418,1603,1060,863,528,137,10609
E02006334,5310,1488,1063,713,445,143,9162
E02006335,4407,1274,1025,815,397,93,8011
E02006336,4749,1014,624,432,259,37,7115
E02006337,5157,1365,1021,879,461,71,8954
E02006338,4191,1057,758,667,295,55,7023
E02006339,7759,1445,869,611,208,44,10936
E02006341,6601,1325,889,758,416,90,10079
E02006342,5830,863,660,634,438,138,8563
E02006343,5374,1274,926,773,380,80,8807
E02006837,6323,1707,1193,1142,619,155,11139
E02006344,4655,1350,1103,1019,476,101,8704
E02006345,4850,827,659,570,274,52,7232
E02006346,5494,1715,1229,1109,578,148,10273
E02006347,4774,962,801,639,298,61,7535
E02006348,5291,1175,981,811,461,107,8826
E02006349,6428,966,641,471,266,71,8843
E02006350,4665,773,550,368,201,35,6592
E02006351,5749,1242,811,594,276,72,8744
E02006352,5159,734,536,427,190,24,7070
E02006353,3985,874,608,569,293,40,6369
E02006354,5892,1440,994,806,538,111,9781
E02006355,8647,737,503,299,195,43,10424
E02006356,9527,1229,797,452,282,85,12372
E02006357,3595,1004,831,634,230,45,6339
E02006358,7668,687,508,400,211,54,9528
E02006359,3950,869,696,554,241,85,6395
E02006360,4547,1279,917,793,503,227,8266
E02006361,2920,989,768,664,298,66,5705
E02006362,3617,1055,776,730,423,90,6691
E02006363,3404,943,749,629,377,119,6221
E02006364,5170,1011,657,474,250,65,7627
E02006365,3218,977,759,731,434,113,6232
E02006366,4143,1285,1063,890,505,100,7986
E02006367,2802,949,725,782,475,104,5837
E02006368,2650,852,769,707,438,121,5537
E02006369,2635,1127,974,893,496,94,6219
E02006370,3578,992,753,578,294,78,6273
E02006371,4136,1096,845,663,444,145,7329
E02006372,3850,989,720,553,331,65,6508
E02006373,4121,1300,995,790,378,78,7662
E02006374,3681,1261,1004,816,303,58,7123
E02006375,3795,1082,785,678,321,59,6720
E02006376,5040,1293,966,946,634,285,9164
E02006377,3177,982,803,688,348,114,6112
E02006378,5333,1516,960,723,396,94,9022
E02006379,4589,822,578,413,180,49,6631
E02006380,3460,1140,1000,837,504,136,7077
E02006381,3678,1233,952,820,418,103,7204
E02006382,4469,904,585,429,199,60,6646
E02006383,6379,1403,922,834,575,228,10341
E02006384,7502,1436,968,735,423,83,11147
E02006385,8870,1316,745,482,266,59,11738
E02006386,5509,1185,753,603,304,95,8449
E02006387,4154,987,587,574,259,62,6623
E02006388,6054,1266,844,642,250,55,9111
E02006389,4144,1047,788,628,322,64,6993
E02006390,5563,1157,940,704,353,83,8800
E02006391,5199,1025,816,500,199,53,7792
E02006392,5764,1226,953,728,382,125,9178
E02006393,4952,719,467,371,244,60,6813
E02006394,10399,996,755,610,364,67,13191
E02006395,6478,1345,923,566,342,79,9733
E02006396,3314,938,780,708,330,69,6139
E02006397,4017,1012,695,536,372,96,6728
E02006398,5578,1127,749,591,330,78,8453
E02006399,7657,1571,1148,926,520,109,11931
E02006400,3355,891,696,581,294,98,5915
E02006401,6759,1421,946,842,487,129,10584
E02006402,5855,1512,997,968,491,114,9937
E02006403,4255,904,656,433,179,40,6467
E02006404,5564,923,555,426,241,67,7776
E02006405,6813,1535,1106,917,440,93,10904
E02006406,6025,1184,739,466,282,65,8761
E02006407,5146,1389,923,800,459,85,8802
E02006408,5442,1186,777,657,426,63,8551
E02006409,4243,1000,722,536,262,61,6824
E02006410,5595,1092,806,536,300,57,8386
E02006411,3974,1100,808,724,411,83,7100
E02006412,4301,1062,826,772,381,89,7431
E02006413,3389,882,733,625,370,87,6086
E02006414,3412,1026,761,593,331,74,6197
E02006415,3257,1045,792,862,499,104,6559
E02006416,4364,1456,1146,878,466,69,8379
E02006417,3722,840,630,542,255,76,6065
E02006418,3510,1149,828,722,393,118,6720
E02006419,5393,1181,709,478,332,47,8140
E02006420,4286,1237,836,794,497,125,7775
E02006421,5483,1434,926,727,377,82,9029
E02006422,3714,884,661,595,249,28,6131
E02006423,7136,1500,1041,847,545,127,11196
E02006424,3525,953,759,682,370,59,6348
E02006425,4056,960,636,558,281,70,6561
E02006426,3325,851,650,510,188,21,5545
E02006427,4574,993,658,644,424,123,7416
E02006429,4907,1109,822,674,300,67,7879
E02006430,6433,1353,865,700,329,78,9758
E02006431,7319,1554,1130,883,433,151,11470
E02006432,3211,951,629,616,326,117,5850
E02006433,5147,1456,1094,988,643,187,9515
E02006434,3983,911,692,552,304,79,6521
E02006435,3471,1070,790,602,238,67,6238
E02006436,3594,900,646,589,280,89,6098
E02006437,4621,1406,1051,1029,466,183,8756
E02006438,4226,1418,1115,950,391,86,8186
E02006790,4232,1201,973,843,492,117,7858
E02006439,3324,939,677,627,324,44,5935
E02006440,4064,1045,790,719,322,48,6988
E02006441,5348,1024,719,696,474,191,8452
E02006442,3480,924,725,639,420,91,6279
E02006443,4330,982,825,673,405,123,7338
E02006444,4446,978,696,602,326,73,7121
E02006445,5503,913,700,614,290,91,8111
E02006446,3771,1102,836,713,395,97,6914
E02006447,3680,960,706,634,338,75,6393
E02006448,4550,1023,779,629,322,77,7380
E02006449,3716,1084,791,737,524,133,6985
E02006450,4177,1147,847,675,337,80,7263
E02006451,6202,1508,1371,1474,702,146,11403
E02006453,4184,1202,981,1043,551,155,8116
E02006454,3684,1022,740,647,450,163,6706
E02006455,3749,899,633,471,287,143,6182
E02006839,4468,1484,1065,963,604,178,8762
E02006456,4719,1056,742,638,346,94,7595
E02006457,4835,1376,1038,1001,550,204,9004
E02006458,5095,1376,1038,840,518,132,8999
E02006459,7824,1180,806,373,202,50,10435
E02006460,5790,1200,1040,626,264,73,8993
E02006461,3950,944,749,603,428,144,6818
E02006462,5103,1222,778,585,290,33,8011
E02006463,7889,1161,769,576,349,106,10850
E02006464,3858,959,764,602,347,59,6589
E02006465,3442,897,714,535,271,86,5945
E02006466,7551,1295,821,591,313,97,10668
E02006467,4109,1072,791,592,277,45,6886
E02006468,6188,1653,1314,1248,520,88,11011
E02006469,5608,1351,1053,763,329,96,9200
E02006470,7004,1711,1435,1169,582,120,12021
E02006471,3483,1167,1049,900,307,41,6947
E02006472,5507,1487,1144,955,352,104,9549
E02006473,5640,1562,1208,1049,580,121,10160
E02006474,3326,1116,843,701,311,79,6376
E02006475,4883,1195,996,873,462,74,8483
E02006476,6134,1041,807,544,236,47,8809
E02006477,4101,1217,1009,794,373,53,7547
E02006478,5004,1234,857,547,149,11,7802
E02006479,6340,1168,825,610,243,58,9244
E02006480,4632,1059,887,634,227,27,7466
E02006481,4549,860,711,630,228,28,7006
E02006482,4522,994,746,609,220,31,7122
E02006483,5296,1120,745,604,327,80,8172
E02006484,4697,1108,730,639,347,66,7587
E02006485,2931,1126,1044,852,358,56,6367
E02006486,3926,1091,874,698,302,67,6958
E02006487,3957,894,807,797,348,73,6876
E02006488,2663,900,884,1035,554,60,6096
E02006489,5338,1091,796,613,204,21,8063
E02006490,4741,1054,875,611,368,71,7720
E02006806,5318,1175,934,688,376,74,8565
E02006492,8264,1987,1383,1087,487,160,13368
E02006493,7226,1466,955,560,183,38,10428
E02006494,5004,979,710,519,281,85,7578
E02006495,4065,1096,940,1002,418,66,7587
E02006496,5131,931,513,360,122,23,7080
E02006497,6021,1053,629,427,212,37,8379
E02006498,9119,1816,1126,917,334,61,13373
E02006499,3533,866,565,566,286,66,5882
E02006500,3497,758,637,625,350,103,5970
E02006501,5886,1330,1072,1081,517,150,10036
E02006502,5470,1425,1270,1457,852,256,10730
E02006503,4173,1414,1081,1135,585,136,8524
E02006504,2666,1041,897,810,343,68,5825
E02006505,3013,1052,923,1114,559,119,6780
E02006506,3279,840,705,668,368,82,5942
E02006507,5609,1494,1119,990,497,92,9801
E02006508,5572,1666,1297,1241,486,103,10365
E02006509,2998,928,800,786,487,102,6101
E02006510,3330,1075,1003,995,454,76,6933
E02006511,5365,1456,1304,1162,535,170,9992
E02006512,7418,1649,1371,1119,613,147,12317
E02006513,4536,1254,916,940,518,137,8301
E02006514,4704,1342,1219,1178,704,219,9366
E02006515,5586,1680,1387,1234,569,99,10555
E02006516,4993,1497,1249,1047,429,103,9318
E02006517,5021,1353,1091,962,404,107,8938
E02006518,4439,1548,1413,1309,678,177,9564
E02006519,3830,1058,913,973,520,155,7449
E02006520,4316,1290,970,893,442,115,8026
E02006521,3584,1114,840,938,547,117,7140
E02006522,2524,940,804,688,241,43,5240
E02006523,8275,1537,1241,1097,596,181,12927
E02006524,3406,756,549,449,243,76,5479
E02006525,8885,1612,1146,1150,673,212,13678
E02006526,4922,1143,1063,822,373,85,8408
E02006527,6259,1154,941,768,392,137,9651
E02006528,8019,1172,883,628,314,63,11079
E02006529,8451,1606,1094,849,470,115,12585
E02006530,7334,1616,1118,994,473,95,11630
E02006531,8443,1011,783,409,242,49,10937
E02006532,5901,1418,1070,882,381,58,9710
E02006533,6365,1304,899,757,383,106,9814
E02006534,5140,1324,977,856,464,112,8873
E02006535,4034,996,878,893,418,90,7309
E02006536,4199,1079,906,749,412,63,7408
E02006537,6633,1501,1023,880,523,121,10681
E02006538,5162,1316,1115,972,499,109,9173
E02006539,3949,1036,882,918,382,81,7248
E02006540,3009,799,756,767,364,61,5756
E02006541,4110,1072,958,1006,562,145,7853
E02006542,2453,914,939,871,390,82,5649
E02006543,2582,943,810,771,356,75,5537
E02006544,5481,1670,1490,1355,598,162,10756
E02006545,7031,1406,1047,789,310,61,10644
E02006546,5428,1449,1271,1403,706,174,10431
E02006547,3645,938,908,689,288,80,6548
E02006548,5259,1331,1134,1069,581,135,9509
E02006549,1809,871,1062,1354,712,158,5966
E02006550,4166,1329,1379,1439,789,149,9251
E02006551,2190,969,1464,1979,1128,332,8062
E02006552,4201,1076,860,703,347,113,7300
E02006553,5216,1226,1087,918,459,69,8975
E02006554,2778,915,1108,1139,574,116,6630
E02006555,4830,1168,845,619,343,116,7921
E02006556,4827,1403,1311,1538,737,180,9996
E02006557,5167,1182,728,585,300,119,8081
E02006558,7175,1588,1200,1075,633,182,11853
E02006559,2785,1054,1473,1804,957,244,8317
E02006560,3952,1304,1480,1610,852,134,9332
E02006561,3784,1073,851,747,305,54,6814
E02006562,2866,1094,928,781,327,47,6043
E02006563,2673,1042,896,729,369,101,5810
E02006564,3810,1180,1139,1060,575,154,7918
E02006565,3618,1298,1200,1147,556,172,7991
E02006566,3674,1138,1241,1102,646,138,7939
E02006567,3576,1220,1028,922,471,96,7313
E02006568,7510,1400,1164,1025,612,193,11904
E02006569,4367,1126,1219,1164,547,163,8586
E02006570,5440,1083,992,942,656,154,9267
E02006571,4803,1344,1079,1000,529,137,8892
E02006572,6469,1495,1231,978,426,85,10684
E02006573,4770,1657,1705,1837,970,268,11207
E02006574,4282,1643,1803,1854,947,232,10761
E02006575,6229,1012,740,418,216,50,8665
E02006576,5846,1144,937,639,303,64,8933
E02006577,5687,981,764,543,382,145,8502
E02006578,8264,1228,830,556,373,114,11365
E02006579,5412,1052,732,518,296,72,8082
E02006580,5239,1121,816,550,403,102,8231
E02006581,6333,1133,794,563,323,91,9237
E02006582,5237,1199,709,424,142,38,7749
E02006583,5909,1254,920,665,362,93,9203
E02006584,5443,1066,699,349,95,35,7687
E02006585,5015,1008,737,482,405,61,7708
E02006586,6086,959,689,266,56,11,8067
E02006587,6393,1112,858,459,139,19,8980
E02006588,5679,1358,961,771,306,44,9119
E02006589,6367,1881,1428,1079,499,106,11360
E02006590,5379,1390,990,822,432,91,9104
E02006591,5175,1192,850,654,425,119,8415
E02006592,3552,1145,894,692,325,90,6698
E02006593,7084,1546,1060,836,694,241,11461
E02006594,6853,1364,1037,729,357,88,10428
E02006595,4806,1455,1066,957,447,70,8801
E02006596,5661,1603,1080,640,276,53,9313
E02006597,6370,1668,1195,1050,523,105,10911
E02006598,2766,987,824,620,270,61,5528
E02006599,2341,1177,1297,1301,637,117,6870
E02006600,4776,1418,1361,1430,700,210,9895
E02006601,4389,1361,1189,1102,644,153,8838
E02006602,4383,1418,1143,994,424,71,8433
E02006603,3985,1371,1215,1292,620,134,8617
E02006604,7989,1778,1366,1103,600,211,13047
E02006605,3787,970,761,643,288,70,6519
E02006606,4956,1367,1024,848,339,55,8589
E02006607,4450,1222,962,907,444,117,8102
E02006608,3355,907,922,799,335,33,6351
E02006609,3823,1158,896,741,305,59,6982
E02006610,4311,1225,871,657,354,108,7526
E02006611,6498,1460,1254,1325,646,158,11341
E02006612,8038,1384,970,923,543,195,12053
E02006613,5166,1072,767,570,284,67,7926
E02006614,7406,1800,1203,997,462,104,11972
E02006615,4583,1121,674,443,188,47,7056
E02006616,5528,1220,951,853,437,61,9050
E02006617,5772,1232,966,800,445,107,9322
E02006618,3251,994,851,670,422,111,6299
E02006619,5350,1356,1073,724,341,86,8930
E02006620,5273,1473,1157,1108,779,167,9957
E02006621,3084,1230,1232,1319,650,133,7648
E02006622,4187,1194,1004,938,515,137,7975
E02006623,4776,1130,967,817,347,78,8115
E02006624,4330,1195,851,659,367,79,7481
E02006625,5206,1239,759,525,262,59,8050
E02006626,6376,1203,930,561,248,50,9368
E02006627,5313,1344,982,979,506,105,9229
E02006628,6344,1327,723,537,297,59,9287
E02006629,4866,1177,831,659,360,93,7986
E02006630,4535,1277,947,982,701,311,8753
E02006631,6592,1391,848,779,505,173,10288
E02006632,4157,1170,1143,1036,626,176,8308
E02006633,3193,1272,1216,1456,778,167,8082
E02006696,4182,986,648,788,462,96,7162
E02006697,3603,1337,1051,898,472,145,7506
E02006698,3518,1069,798,644,416,78,6523
E02006699,3159,862,796,793,380,75,6065
E02006700,3071,968,797,775,499,150,6260
E02006701,3936,1054,902,711,327,90,7020
E02006702,3726,830,669,572,270,58,6125
E02006703,4251,1219,1018,793,357,84,7722
E02006704,3825,1029,943,790,418,110,7115
E02006705,4482,1015,746,655,314,87,7299
E02006706,4140,1013,861,738,508,192,7452
E02006707,4198,1052,690,662,326,65,6993
E02006708,5708,1131,769,531,271,60,8470
E02006709,4607,1291,1113,787,293,78,8169
E02006710,3766,1337,1238,1195,542,121,8199
E02006711,3908,1424,1272,1109,506,80,8299
E02006712,3434,1220,1105,1013,491,95,7358
E02006713,3182,1018,796,796,506,140,6438
E02006714,2503,950,825,856,397,119,5650
E02006715,4916,1362,1093,843,366,59,8639
E02006716,3869,881,734,565,286,62,6397
E02006717,3108,1014,946,901,382,119,6470
E02006718,2897,854,924,879,493,170,6217
E02006719,3780,1086,1186,1050,627,164,7893
E02006720,3125,1244,1167,985,499,118,7138
E02006721,3494,761,866,742,259,46,6168
E02006722,3876,541,605,305,74,14,5415
E02006723,6048,1142,707,508,281,97,8783
E02006724,5379,764,519,330,154,61,7207
E02006725,3545,696,768,441,110,22,5582
E02006726,4313,821,662,505,215,41,6557
E02006727,3441,793,759,676,274,40,5983
E02006728,3871,1085,1001,690,398,107,7152
E02006729,4351,880,954,710,184,33,7112
E02006730,4890,637,573,400,131,29,6660
E02006731,3148,848,734,612,214,53,5609
E02006732,3973,1063,946,702,287,33,7004
E02006733,3198,987,796,714,263,71,6029
E02006734,4372,1118,1020,896,536,134,8076
E02006735,3759,703,480,333,201,20,5496
E02006736,4151,1072,560,347,136,15,6281
E02006737,5129,1091,881,749,261,59,8170
E02006738,6283,1078,784,561,248,40,8994
E02006739,3551,644,515,576,337,68,5691
E02006740,5409,930,685,469,219,71,7783
E02006741,3939,913,549,360,219,49,6029
E02006742,5994,922,845,673,342,60,8836
E02006743,4376,854,659,472,166,23,6550
E02006744,5188,919,626,401,226,60,7420
E02006745,4542,1124,1008,890,483,120,8167
E02006746,5124,1110,922,750,364,62,8332
E02006747,3200,893,581,469,224,30,5397
E02006748,4309,1266,1066,839,415,90,7985
E02006749,3334,690,567,491,163,34,5279
E02006750,2741,701,716,704,436,144,5442
E02006751,3124,902,751,745,364,105,5991
E02006752,4018,1160,995,882,359,53,7467
E02006753,3502,1124,979,862,348,70,6885
E02006754,2704,988,856,808,278,38,5672
E02006755,2429,1039,935,883,369,66,5721
E02006756,3673,1025,732,539,235,113,6317
E02006757,2966,1231,1243,1033,490,118,7081
E02006758,3119,1094,822,698,245,47,6025
E02006759,3942,1119,1147,1125,583,180,8096
E02006760,4745,1421,1296,1098,509,145,9214
E02006761,4427,817,647,434,266,104,6695
E02006762,3982,975,749,727,320,67,6820
E02006763,5422,1193,950,717,371,55,8708
E02006764,3933,821,648,452,194,57,6105
E02006765,2492,1000,1056,978,523,144,6193
E02006766,3339,1361,1326,1143,474,94,7737
E02006767,4435,1493,1234,1267,550,127,9106
E02006768,3756,954,797,933,360,83,6883
E02006769,4001,1006,820,754,357,72,7010
E02006770,6040,981,685,565,197,74,8542
E02006771,3111,1142,1091,1025,400,65,6834
E02006772,3460,971,777,794,447,103,6552
E02006773,4575,1058,1099,1104,487,116,8439
E02006774,4651,1086,827,682,291,42,7579
E02006775,4001,767,576,475,202,52,6073
E02006776,3375,1010,944,774,251,65,6419
E02006777,2940,1127,1204,1105,582,96,7054
E02006778,3741,1050,801,866,450,106,7014
E02006779,4196,1229,1018,987,436,65,7931
E02006780,2917,769,841,928,312,88,5855
E02004924,5136,1175,685,598,267,70,7931
E02004925,5284,1114,669,490,305,106,7968
E02004926,4977,1207,674,690,484,111,8143
E02004927,3793,959,704,641,378,61,6536
E02004928,3813,1053,806,629,385,66,6752
E02004929,3667,935,660,701,341,99,6403
E02004930,4259,1067,718,534,287,79,6944
E02004931,4181,954,695,478,362,78,6748
E02004932,5400,996,690,450,191,61,7788
E02004933,4509,1021,694,450,268,59,7001
E02004934,6070,936,584,325,259,61,8235
E02004935,6911,975,621,317,199,62,9085
E02004936,4579,890,497,370,155,34,6525
E02004937,4113,986,786,841,469,162,7357
E02004938,4190,984,574,429,211,30,6418
E02004939,4608,877,603,495,324,83,6990
E02004940,5300,906,621,414,240,98,7579
E02004941,6389,1386,980,610,308,55,9728
E02004942,3668,945,722,699,333,78,6445
E02004943,4235,1205,931,916,479,110,7876
E02004980,3161,1057,803,720,446,173,6360
E02004981,4964,1091,798,634,373,89,7949
E02004982,3619,945,602,516,317,60,6059
E02004983,3938,780,637,462,282,52,6151
E02004984,3884,895,854,461,257,101,6452
E02004985,3853,1006,768,758,530,163,7078
E02004986,6155,971,579,307,166,37,8215
E02004987,5164,960,638,426,269,66,7523
E02004988,5733,955,619,420,253,40,8020
E02004989,11694,1073,717,499,237,83,14303
E02004990,4926,863,664,476,314,103,7346
E02004991,7102,861,515,305,223,64,9070
E02004992,9535,795,482,357,257,54,11480
E02004993,3524,755,632,509,249,63,5732
E02004994,3276,923,737,634,321,69,5960
E02004995,2689,854,733,635,369,65,5345
E02004878,4742,1344,957,876,339,104,8362
E02004879,4431,1451,1070,874,377,68,8271
E02004880,5414,1785,1102,774,371,73,9519
E02004881,4234,843,618,485,417,75,6672
E02004882,6076,1177,742,614,324,56,8989
E02004883,3578,967,674,638,260,51,6168
E02004884,7346,1485,983,636,360,68,10878
E02004885,5275,1502,833,593,273,53,8529
E02004886,3697,1003,788,599,351,64,6502
E02004887,4186,1238,1066,792,351,50,7683
E02004888,5144,1357,1117,924,439,90,9071
E02004889,7346,1565,987,846,616,172,11532
E02004890,5085,1348,980,703,381,63,8560
E02004891,4862,1135,859,746,396,91,8089
E02004892,3658,881,541,345,200,68,5693
E02004893,4126,981,457,312,80,27,5983
E02004894,6339,1284,858,672,389,132,9674
E02004895,5708,1455,1092,900,318,100,9573
E02004944,5475,967,610,420,147,23,7642
E02004945,7964,1682,1190,865,469,118,12288
E02004946,3989,961,643,446,247,54,6340
E02004947,3573,1098,725,474,249,28,6147
E02004948,3788,785,735,444,220,53,6025
E02004949,5652,1118,751,699,436,141,8797
E02004950,4531,944,603,448,256,34,6816
E02004951,5607,955,619,419,279,76,7955
E02004952,4213,1002,711,391,282,72,6671
E02004953,4313,911,519,380,211,44,6378
E02004954,4535,959,643,442,279,65,6923
E02004955,3599,880,688,387,271,38,5863
E02006287,2348,981,1260,1044,433,113,6179
E02006288,4616,1538,1426,1229,622,131,9562
E02006289,4556,1497,1412,1327,627,108,9527
E02006290,3767,1145,1208,1211,610,188,8129
E02006291,3587,1187,1263,1046,490,108,7681
E02006292,3287,1143,1118,851,385,73,6857
E02006293,6435,1806,1492,1167,438,113,11451
E02006294,3750,1148,1084,1204,790,252,8228
E02006295,5371,1356,1105,1147,662,155,9796
E02006296,7947,1883,1574,1316,648,121,13489
E02006297,4024,1452,1128,945,580,97,8226
E02006298,4908,1452,1410,1050,402,68,9290
E02006299,3101,1227,1459,1557,849,188,8381
E02006300,4532,1127,930,791,319,82,7781
E02006301,3261,929,871,761,430,199,6451
E02006302,2923,1009,1138,1104,443,125,6742
E02006303,5090,1075,819,743,357,68,8152
E02006304,3633,1105,1088,1256,570,122,7774
E02006305,6746,1400,843,730,255,50,10024
E02006306,4075,1004,904,979,442,106,7510
E02006307,3215,1015,1113,1197,608,155,7303
E02006308,4710,1130,905,604,290,97,7736
E02006309,3550,923,886,852,563,125,6899
E02006310,5098,1250,852,862,376,84,8522
E02006311,4299,1081,1121,1167,629,174,8471
E02006312,4491,1354,1211,1179,531,64,8830
E02006313,4738,1425,1510,1555,685,120,10033
E02006314,3693,1039,1128,928,471,124,7383
E02006315,2318,865,1048,956,515,146,5848
E02006316,3168,1022,1076,1141,655,144,7206
E02006238,5380,1285,1275,1199,530,116,9785
E02006239,5533,686,612,570,260,58,7719
E02006240,7353,1157,958,684,280,53,10485
E02006241,5513,1130,974,854,463,120,9054
E02006242,6935,1153,841,644,316,105,9994
E02006243,5705,1232,915,703,316,95,8966
E02006273,3238,1063,997,933,417,78,6726
E02006274,4159,966,690,636,295,74,6820
E02006275,4540,1003,619,623,276,81,7142
E02006276,3156,1024,1001,1012,523,158,6874
E02006277,5472,1106,703,501,186,26,7994
E02006278,5170,1170,937,852,525,139,8793
E02006279,4647,1263,1078,1131,572,134,8825
E02006280,4989,1500,1286,1254,620,140,9789
E02006281,4351,1070,1064,1218,802,295,8800
E02006282,2817,1032,990,979,430,120,6368
E02006283,4326,1150,912,867,316,55,7626
E02006284,4895,1053,819,737,370,59,7933
E02006285,5278,1112,640,499,187,57,7773
E02006286,7791,1448,1068,919,431,118,11775
E02006826,6078,1247,1031,819,515,114,9804
E02006099,3866,1042,969,711,298,88,6974
E02006100,4517,1168,937,776,383,73,7854
E02006101,2629,984,909,734,367,89,5712
E02006102,3988,974,863,604,351,92,6872
E02006103,3833,1188,1170,1120,472,94,7877
E02006104,6416,1401,1033,785,297,64,9996
E02006105,7487,1443,1054,785,468,110,11347
E02006106,6156,1230,1024,774,414,130,9728
E02006107,5340,1112,984,631,316,109,8492
E02006108,4883,1130,925,982,743,249,8912
E02006109,4104,1134,1017,1061,631,135,8082
E02006110,5711,1348,1156,858,465,102,9640
E02006111,4918,1645,1590,1594,714,222,10683
E02006112,3578,1320,1289,1010,491,183,7871
E02006113,3441,1065,1022,1071,653,223,7475
E02006114,2795,887,1143,1087,565,123,6600
E02006115,3226,1104,1394,1133,490,82,7429
E02006116,3174,1309,1460,1302,594,154,7993
E02006117,1937,1021,1107,970,452,91,5578
E02000984,4182,1239,913,844,289,43,7510
E02000985,3577,1186,947,989,485,71,7255
E02000986,5042,1272,897,781,418,96,8506
E02000987,4120,1155,788,717,340,85,7205
E02000988,6027,1095,832,590,289,65,8898
E02000989,3942,1192,1075,1243,603,72,8127
E02000990,4613,1212,969,764,294,45,7897
E02000991,4693,1107,859,634,281,76,7650
E02000992,3365,919,682,684,347,49,6046
E02000993,6022,948,677,375,193,36,8251
E02000994,6124,1006,664,468,177,28,8467
E02000995,4937,1111,923,739,392,97,8199
E02000996,5901,1023,687,520,281,91,8503
E02000997,3463,920,746,643,262,81,6115
E02000998,7101,1018,730,471,196,50,9566
E02000999,5756,960,692,464,215,71,8158
E02001000,5916,1187,959,743,422,79,9306
E02001001,6101,1159,804,483,280,73,8900
E02001002,6045,1318,1091,867,335,47,9703
E02001003,3941,1027,960,899,416,112,7355
E02001004,6473,908,705,402,159,41,8688
E02001005,6756,901,707,392,221,37,9014
E02001006,6270,888,593,396,178,24,8349
E02001007,5474,1398,1296,1311,401,53,9933
E02001008,6741,839,606,369,196,62,8813
E02001009,4859,911,689,608,272,52,7391
E02001010,4512,764,516,258,129,20,6199
E02001011,5576,1435,1265,957,405,57,9695
E02001012,5871,1022,744,570,190,39,8436
E02001013,3495,915,645,723,323,46,6147
E02001014,4787,1195,949,743,292,63,8029
E02001015,5017,1159,878,791,390,88,8323
E02001016,6073,1022,669,545,200,34,8543
E02001017,6823,1625,1048,935,377,47,10855
E02001018,4568,1276,889,567,200,18,7518
E02001019,5485,1342,969,799,327,47,8969
E02001020,2783,836,809,900,385,97,5810
E02001021,3991,1325,973,774,336,85,7484
E02001022,4429,1161,940,842,430,91,7893
E02001023,3318,776,716,678,202,21,5711
E02001024,4848,1246,911,807,312,61,8185
E02001025,5337,1044,782,536,278,57,8034
E02001026,7988,1195,779,479,237,47,10725
E02001027,5122,973,568,473,214,62,7412
E02001028,3355,1095,1001,1166,508,107,7232
E02001029,5267,968,677,437,204,47,7600
E02001030,3318,1052,703,549,183,49,5854
E02001031,4121,943,712,598,225,28,6627
E02001032,4585,1077,854,772,355,60,7703
E02001033,4070,885,500,389,158,30,6032
E02001034,5678,1128,771,586,255,53,8471
E02001035,3702,1098,804,823,420,74,6921
E02001036,5184,1014,750,541,205,33,7727
E02001037,3748,993,915,799,440,98,6993
E02001038,3624,809,590,472,269,45,5809
E02001039,5865,1104,672,533,282,28,8484
E02001040,3615,932,727,570,262,53,6159
E02001041,4985,1029,770,507,324,87,7702
E02001042,3942,922,662,565,251,70,6412
E02001043,3408,789,535,401,225,115,5473
E02001044,7201,894,758,481,189,45,9568
E02001045,5453,1011,805,604,264,62,8199
E02001046,7504,1254,818,542,248,48,10414
E02001047,6769,1360,867,636,285,37,9954
E02001048,6435,1037,733,514,252,57,9028
E02001049,6102,1414,1006,730,344,91,9687
E02001050,6418,929,620,412,152,32,8563
E02001051,6297,1158,760,463,270,49,8997
E02001052,11210,1198,904,471,326,92,14201
E02001053,8298,1351,769,484,201,31,11134
E02001055,6294,1128,865,590,242,72,9191
E02001056,5974,980,677,474,187,25,8317
E02001057,9381,902,596,344,159,37,11419
E02001059,9327,1199,774,457,178,32,11967
E02001061,7030,1265,858,553,226,34,9966
E02001062,9278,862,470,276,119,26,11031
E02001063,13463,595,325,159,77,27,14646
E02001064,7789,1169,720,389,220,39,10326
E02001065,7133,1138,697,452,222,29,9671
E02001066,11423,762,452,265,143,52,13097
E02001067,8685,1188,625,388,202,36,11124
E02001068,8561,986,499,304,243,36,10629
E02001069,11043,721,477,288,147,30,12706
E02001070,11221,716,511,304,157,41,12950
E02001071,11728,1300,728,435,217,36,14444
E02001072,7112,935,538,269,138,46,9038
E02001073,6824,1213,773,455,237,44,9546
E02001074,8781,1304,892,452,321,81,11831
E02001075,6948,917,506,269,106,25,8771
E02001076,10906,441,322,157,97,25,11948
E02001077,5126,860,644,343,179,49,7201
E02001078,7493,1045,850,609,358,45,10400
E02001079,6833,875,565,370,179,58,8880
E02001080,8191,494,431,341,180,27,9664
E02001081,4365,907,522,308,174,56,6332
E02001082,5393,529,405,244,123,40,6734
E02001083,7010,531,351,211,81,20,8204
E02001084,6313,843,626,357,195,45,8379
E02001085,6067,1028,658,423,165,31,8372
E02001086,4706,784,487,344,209,65,6595
E02001087,6593,1069,822,616,299,58,9457
E02001088,6289,1135,790,512,259,74,9059
E02001089,5289,983,777,493,278,65,7885
E02001090,3912,981,738,542,268,55,6496
E02001091,5021,1050,878,652,282,82,7965
E02001092,5897,1124,732,447,237,61,8498
E02001093,6770,987,748,512,270,92,9379
E02001094,7150,1046,781,450,157,31,9615
E02001095,5651,1099,755,532,179,56,8272
E02001096,4916,1016,802,510,241,52,7537
E02001097,5540,1078,770,457,179,58,8082
E02006902,6547,416,262,98,26,6,7355
E02006912,17222,327,242,135,106,25,18057
E02006913,6174,571,368,195,81,15,7404
E02006914,10372,252,90,37,58,4,10813
E02006915,7768,915,472,236,87,7,9485
E02006916,5859,395,184,101,43,14,6596
E02006917,6707,354,211,51,22,2,7347
E02001098,2918,846,797,925,314,51,5851
E02001099,3486,919,661,569,224,57,5916
E02001100,3178,869,747,696,350,116,5956
E02001101,2928,833,779,722,216,52,5530
E02001102,3581,1021,639,528,201,42,6012
E02001103,2688,937,789,674,297,58,5443
E02001104,4794,983,722,497,144,29,7169
E02001105,3286,871,733,737,333,59,6019
E02001106,3243,879,668,605,299,74,5768
E02001107,4297,822,586,525,222,37,6489
E02001108,4280,690,405,323,131,44,5873
E02001109,4881,1171,781,534,236,62,7665
E02001110,3287,1082,902,806,296,90,6463
E02001111,5609,835,573,358,200,60,7635
E02001112,3118,902,855,583,222,36,5716
E02001113,7836,744,488,259,147,19,9493
E02001114,5783,1073,809,706,364,61,8796
E02001115,3443,886,676,583,211,49,5848
E02001116,6099,678,511,265,155,46,7754
E02001117,3293,978,768,709,336,47,6131
E02001118,3236,986,769,663,309,67,6030
E02001119,9853,880,717,341,208,74,12073
E02001121,7362,718,442,255,115,27,8919
E02001123,4900,815,571,456,173,26,6941
E02001124,4559,777,567,409,210,35,6557
E02001125,5157,1156,847,605,320,54,8139
E02001126,6769,1014,694,408,191,34,9110
E02001127,5409,966,692,445,174,29,7715
E02001128,4823,1056,829,628,314,49,7699
E02001129,4056,815,590,468,262,40,6231
E02001130,2843,1002,701,554,257,44,5401
E02001131,2931,863,545,555,314,44,5252
E02006860,12495,1245,977,447,288,64,15516
E02001132,3882,957,721,610,251,67,6488
E02001133,3829,971,791,669,214,29,6503
E02001134,3456,1022,819,720,262,61,6340
E02001135,5921,898,605,522,212,45,8203
E02001136,5674,1256,1115,791,357,84,9277
E02001137,3459,992,846,575,211,42,6125
E02001138,4444,1386,1131,1001,488,107,8557
E02001139,7847,824,718,367,168,35,9959
E02001140,5801,976,713,476,263,81,8310
E02001141,9384,1490,963,520,247,67,12671
E02001142,3033,827,778,694,403,63,5798
E02001143,8807,1307,842,569,244,47,11816
E02001144,3937,967,745,585,203,51,6488
E02001145,4206,1045,837,755,255,45,7143
E02001146,7665,951,705,356,260,51,9988
E02001147,6967,1289,904,583,274,30,10047
E02001148,6564,1403,1166,993,403,103,10632
E02001149,6877,1327,1117,772,364,63,10520
E02001150,5776,1282,972,693,264,62,9049
E02001151,6265,1446,1089,898,384,79,10161
E02001152,6091,1292,1044,691,311,56,9485
E02001153,7921,1364,1147,684,322,84,11522
E02001154,6627,1491,1121,656,303,57,10255
E02001155,4486,1092,897,574,302,78,7429
E02001156,5398,1445,1191,891,591,130,9646
E02001157,5940,928,703,467,293,42,8373
E02001158,3949,812,672,440,207,79,6159
E02001159,4861,811,467,430,167,26,6762
E02001160,5036,799,622,457,193,30,7137
E02001161,3534,881,705,486,284,38,5928
E02001162,3653,793,637,635,339,39,6096
E02001163,5492,1397,1102,959,458,80,9488
E02001164,5806,893,561,375,103,30,7768
E02001165,3782,872,581,477,211,45,5968
E02001166,5296,617,632,424,228,112,7309
E02001167,5090,745,631,443,226,52,7187
E02001168,6106,1302,999,726,370,79,9582
E02001169,5933,1624,1311,1002,405,95,10370
E02001170,5544,1382,1027,1026,564,138,9681
E02001171,3480,861,668,574,267,63,5913
E02001172,12429,1328,890,604,352,91,15694
E02001173,6090,840,551,391,158,41,8071
E02001174,3575,700,603,412,232,54,5576
E02001175,4936,1000,628,458,205,45,7272
E02001176,7056,1582,1232,943,546,108,11467
E02001177,9207,1501,1166,808,443,119,13244
E02001178,13240,994,541,259,82,20,15136
E02001179,4795,725,601,404,193,47,6765
E02001180,5037,635,448,286,121,18,6545
E02001181,4156,886,525,362,149,40,6118
E02001182,4513,841,630,356,174,52,6566
E02001183,4871,815,559,344,168,34,6791
E02001184,13091,1152,652,423,154,18,15490
E02001185,6121,1439,992,937,386,69,9944
E02001186,6876,1445,917,792,333,71,10434
E02001187,4357,1047,814,585,239,40,7082
E02001188,6102,1089,695,482,184,39,8591
E02001189,5061,1288,902,704,301,52,8308
E02001190,5347,807,589,346,234,68,7391
E02001191,2999,845,810,668,307,60,5689
E02001192,4391,965,659,507,367,115,7004
E02001193,4194,860,621,421,213,34,6343
E02001194,3856,922,732,549,250,54,6363
E02001195,4298,1059,879,662,333,68,7299
E02001196,4201,1157,920,926,504,88,7796
E02001197,3966,961,721,455,245,25,6373
E02001198,4306,1024,775,883,443,136,7567
E02001199,4870,1124,920,639,317,65,7935
E02001200,5091,1045,742,471,166,66,7581
E02001201,3731,846,539,421,210,44,5791
E02001202,4517,805,507,324,130,29,6312
E02001203,2895,927,855,815,336,70,5898
E02001204,6207,1190,930,515,298,83,9223
E02001205,5387,1167,827,545,220,41,8187
E02001206,3871,1107,876,761,532,103,7250
E02001207,3830,1076,993,698,343,37,6977
E02001208,4851,1047,802,514,294,64,7572
E02001209,5325,1100,722,490,235,67,7939
E02001210,4665,964,726,632,356,62,7405
E02001211,3766,898,731,537,362,114,6408
E02001212,5177,873,485,339,175,20,7069
E02001213,6224,1522,1145,765,367,114,10137
E02001214,4298,1098,905,795,464,94,7654
E02001215,3025,831,817,804,413,65,5955
E02001216,4295,1005,904,777,425,75,7481
E02001217,4319,848,622,648,377,97,6911
E02001218,3382,844,740,626,335,62,5989
E02001219,2824,811,706,691,328,64,5424
E02001220,3314,856,686,567,252,30,5705
E02001221,3138,841,741,735,359,82,5896
E02001222,3651,834,784,703,398,77,6447
E02001223,3436,1042,898,744,430,105,6655
E02001224,2479,916,818,959,505,117,5794
E02001225,4167,1106,801,783,432,94,7383
E02001226,4435,943,733,616,317,50,7094
E02001227,2973,840,694,778,456,107,5848
E02001228,2879,885,720,686,422,105,5697
E02001229,6289,1573,1141,862,274,44,10183
E02001230,3261,920,735,768,262,31,5977
E02001231,4619,1060,784,595,145,11,7214
E02001232,5535,1160,791,636,306,59,8487
E02001233,4785,1065,954,720,301,62,7887
E02001234,5203,1028,756,546,247,43,7823
E02001235,4793,905,661,491,233,38,7121
E02001236,3923,771,550,424,227,60,5955
E02001237,4627,1033,703,477,211,64,7115
E02001238,4605,1223,949,732,342,42,7893
E02001239,6074,1376,923,690,327,49,9439
E02001240,3748,931,653,537,248,30,6147
E02001241,8022,1257,872,511,163,34,10859
E02001242,4101,1001,721,550,301,64,6738
E02001243,4544,1210,1002,859,332,62,8009
E02001244,3017,787,664,675,210,44,5397
E02001245,5361,1152,850,569,263,35,8230
E02001246,4425,1079,809,641,318,83,7355
E02001247,4326,1061,720,534,263,38,6942
E02001248,7942,1444,1059,689,219,44,11397
E02001249,3964,887,638,506,244,47,6286
E02001250,3673,1075,809,704,244,29,6534
E02001251,3110,978,864,675,265,41,5933
E02001252,4016,1126,856,753,490,62,7303
E02001253,2847,764,576,478,215,44,4924
E02001254,3346,844,616,581,220,31,5638
E02001255,4708,897,595,454,211,34,6899
E02001256,7364,1334,828,618,359,81,10584
E02001257,5097,1408,1009,971,491,54,9030
E02001258,3953,1117,888,796,371,69,7194
E02001259,8641,1323,730,325,262,50,11331
E02001260,4484,1135,872,761,282,63,7597
E02001261,6292,1099,606,359,194,31,8581
E02001262,5871,1230,728,447,307,64,8647
E02001263,4588,1320,976,880,452,89,8305
E02001264,5697,1212,766,519,274,35,8503
E02001265,4904,1170,953,722,319,81,8149
E02001266,4322,1134,719,509,264,60,7008
E02001267,4468,1142,785,579,459,122,7555
E02001268,3749,1103,886,751,414,74,6977
E02001269,5514,1107,878,508,309,68,8384
E02001270,5784,1066,732,572,287,101,8542
E02001271,3964,974,773,512,270,78,6571
E02001272,5226,1113,859,684,419,76,8377
E02001273,6896,1210,879,702,402,115,10204
E02001274,4247,1213,1038,942,482,143,8065
E02001275,5704,1107,875,519,315,55,8575
E02001276,5386,1025,803,590,304,70,8178
E02001277,6960,1269,735,550,175,32,9721
E02001278,5519,1196,875,681,344,99,8714
E02001279,5117,1280,942,690,390,73,8492
E02001280,5203,1169,861,732,365,104,8434
E02001281,4293,1078,862,822,464,98,7617
E02001282,7235,1171,831,609,296,67,10209
E02001283,5877,1390,958,883,525,130,9763
E02001284,5431,1305,803,556,279,77,8451
E02001285,4409,1215,970,825,464,166,8049
E02001286,4683,1163,917,881,575,136,8355
E02001287,3489,981,655,583,226,61,5995
E02001288,4257,1267,1014,905,414,65,7922
E02001289,5307,1526,1343,1308,549,70,10103
E02001290,3393,1046,716,685,269,55,6164
E02001291,4741,1138,823,694,291,41,7728
E02001292,4399,1301,1030,812,436,81,8059
E02001293,3387,994,757,702,234,29,6103
E02001294,4958,1235,777,559,312,52,7893
E02001295,4780,1244,857,541,273,42,7737
E02001296,7051,1158,749,556,228,31,9773
E02001297,4105,967,790,586,226,34,6708
E02001298,5974,1056,754,576,226,79,8665
E02001299,5536,1407,854,802,326,71,8996
E02001300,5043,1156,899,791,343,73,8305
E02001301,6216,1166,798,593,298,69,9140
E02001302,4750,1187,880,793,319,70,7999
E02001303,6108,1204,845,557,221,43,8978
E02001304,7314,1939,1439,1471,657,104,12924
E02001305,4646,1193,1041,1028,298,41,8247
E02001306,3912,1127,965,963,286,29,7282
E02001307,7049,1655,1430,1239,393,29,11795
E02001308,3408,967,710,676,300,67,6128
E02001309,5158,1157,903,719,299,80,8316
E02001310,6443,1170,892,655,221,42,9423
E02001311,4980,1264,988,813,253,49,8347
E02001312,5676,1102,801,638,190,29,8436
E02001313,5262,1140,823,688,238,85,8236
E02001314,5216,1320,1016,624,183,22,8381
E02001315,4884,1196,942,894,310,44,8270
E02001316,4588,891,595,422,172,26,6694
E02001317,5194,1324,966,797,317,73,8671
E02001318,4429,1144,1001,860,395,43,7872
E02001319,4979,1103,858,637,185,50,7812
E02001320,4540,1227,822,713,307,46,7655
E02001321,4899,1215,938,818,311,57,8238
E02001322,3863,1152,925,906,416,56,7318
E02001323,4734,1175,876,843,289,52,7969
E02001324,5293,1221,892,724,304,67,8501
E02001325,4342,1353,998,868,318,69,7948
E02001326,4502,1187,912,938,349,43,7931
E02001327,5868,885,1010,460,121,18,8362
E02001328,6473,1379,1150,833,327,61,10223
E02001329,4724,1036,1040,425,193,73,7491
E02001330,5861,1183,1180,523,253,56,9056
E02001331,6189,1337,1407,746,362,80,10121
E02001332,4725,1110,690,562,261,20,7368
E02001333,5647,1212,889,645,382,86,8861
E02001334,3936,839,571,364,177,30,5917
E02001335,4891,1322,841,609,326,54,8043
E02001336,4703,1007,743,433,325,51,7262
E02001337,3688,937,653,383,268,47,5976
E02001338,3676,877,575,483,254,40,5905
E02001339,4014,896,683,506,250,43,6392
E02001340,5594,1457,1090,771,478,69,9459
E02001341,4681,1037,856,512,315,70,7471
E02001342,3788,1213,995,720,481,106,7303
E02001343,4023,1175,1022,689,322,87,7318
E02001344,3108,857,689,399,293,53,5399
E02001345,3001,857,781,531,264,41,5475
E02001346,4707,1113,840,461,282,57,7460
E02001347,5071,1173,790,495,298,33,7860
E02001348,4353,940,767,443,254,28,6785
E02001349,4862,1177,880,560,242,37,7758
E02001350,5047,1091,924,519,327,111,8019
E02001351,5744,1193,945,506,271,29,8688
E02001352,5017,840,673,451,172,28,7181
E02001353,4453,1249,890,426,258,25,7301
E02001354,4899,1005,858,486,297,38,7583
E02001355,4160,930,744,518,223,65,6640
E02001356,6434,842,542,355,190,24,8387
E02001357,4638,940,719,409,298,49,7053
E02001358,4712,970,644,460,196,30,7012
E02001359,3004,867,756,490,248,26,5391
E02001360,5657,1099,983,671,258,30,8698
E02001361,4438,1174,862,618,274,51,7417
E02001362,3964,1117,971,611,445,77,7185
E02001363,5183,1073,709,509,237,45,7756
E02001364,4015,732,561,367,185,40,5900
E02001365,6828,1134,763,535,242,64,9566
E02001366,5819,1279,901,596,341,76,9012
E02001367,5361,1423,1210,918,492,93,9497
E02001368,4332,877,873,553,297,46,6978
E02001369,5446,973,850,656,251,40,8216
E02001370,4706,860,759,575,251,43,7194
E02001371,4942,921,676,407,249,28,7223
E02001372,3314,904,784,486,361,78,5927
E02001373,6050,1289,945,597,270,36,9187
E02001374,7141,1049,708,472,162,38,9570
E02001375,4076,961,767,569,310,66,6749
E02001376,7328,863,660,421,202,23,9497
E02001377,14047,760,585,452,211,18,16073
E02001378,4729,1113,892,599,322,87,7742
E02001380,4399,1138,878,757,399,78,7649
E02001381,7581,943,695,416,209,31,9875
E02001382,3965,1050,865,599,264,49,6792
E02001383,8021,796,489,321,151,45,9823
E02001384,9428,619,543,303,200,35,11128
E02001385,8187,780,482,329,199,34,10011
E02001386,4355,1095,1002,808,405,54,7719
E02001387,4444,1148,1012,633,423,98,7758
E02001388,6595,736,561,317,221,69,8499
E02001389,5231,636,549,301,143,32,6892
E02001390,6533,1198,867,559,321,59,9537
E02001391,3433,897,566,547,275,44,5762
E02001392,2991,911,857,718,484,90,6051
E02001393,3946,1091,1140,846,391,88,7502
E02001394,6606,1088,840,687,342,98,9661
E02001395,3683,768,756,542,296,51,6096
E02001396,5492,857,779,565,253,27,7973
E02001397,3764,1046,1156,784,477,131,7358
E02001398,4993,920,800,592,329,87,7721
E02001399,4067,1037,916,650,358,65,7093
E02001400,3917,1073,820,523,284,85,6702
E02001401,4362,1078,983,717,492,72,7704
E02001402,5572,1224,1056,867,402,96,9217
E02001403,4723,825,567,352,192,25,6684
E02001404,5169,1071,728,432,220,47,7667
E02001405,6682,1173,1018,537,238,40,9688
E02006932,16963,264,173,80,25,10,17515
E02006933,7130,603,485,220,97,4,8539
E02006934,7653,372,216,98,34,8,8381
E02001406,3521,1205,1088,1271,538,97,7720
E02001407,2660,787,939,946,405,46,5783
E02001408,2866,839,830,753,243,30,5561
E02001409,5874,1466,1297,1061,421,72,10191
E02001410,3436,824,679,606,255,56,5856
E02001411,3299,845,668,667,345,58,5882
E02001412,5435,1323,1080,772,389,72,9071
E02001413,5167,1289,1304,1145,336,50,9291
E02001414,2705,827,717,705,436,80,5470
E02001415,4657,888,614,463,185,29,6836
E02001416,4270,828,692,392,210,37,6429
E02001417,4763,1092,766,473,234,65,7393
E02001418,3975,778,549,435,242,36,6015
E02001419,4798,934,719,526,259,55,7291
E02001420,7594,1633,1130,803,407,81,11648
E02001421,6418,1612,1227,824,386,81,10548
E02001422,4686,885,674,375,219,26,6865
E02001423,3403,1049,888,718,363,73,6494
E02001424,9558,1973,1349,1166,528,91,14665
E02001425,5828,1475,1378,1067,458,43,10249
E02001426,2838,847,625,689,399,44,5442
E02001427,6480,1474,1069,957,342,37,10359
E02001428,2633,813,712,805,497,66,5526
E02001429,3135,977,1012,964,549,72,6709
E02001430,3313,1108,1034,865,540,103,6963
E02001431,2698,1036,1233,1302,939,281,7489
E02001432,4802,1296,1148,934,640,224,9044
E02001433,4934,1113,822,601,273,36,7779
E02001434,4567,1160,904,561,216,45,7453
E02001435,5459,1256,879,625,302,66,8587
E02001436,5357,1351,1052,734,415,89,8998
E02001437,3856,1465,1457,1474,1051,301,9604
E02001438,4149,1138,941,702,332,54,7316
E02001439,3675,954,851,720,369,77,6646
E02001440,2217,840,1002,1184,561,98,5902
E02001441,2793,916,987,1108,538,84,6426
E02001442,2836,845,813,922,632,140,6188
E02001443,2571,812,786,787,478,84,5518
E02001444,2922,802,688,698,376,76,5562
E02001445,3235,1009,1006,829,541,118,6738
E02001446,3443,1016,883,869,485,80,6776
E02001447,2680,827,818,754,528,121,5728
E02001448,3475,1056,927,718,443,67,6686
E02001449,4440,1466,1496,1031,520,82,9035
E02001450,3873,1355,1284,1070,514,160,8256
E02001451,3530,891,691,500,368,63,6043
E02001452,4105,1007,722,453,303,81,6671
E02001453,4803,1381,1237,852,445,111,8829
E02001454,3757,1094,922,650,471,80,6974
E02001455,3926,1172,930,641,395,50,7114
E02001456,4115,1205,1011,716,354,99,7500
E02001457,4305,1031,821,427,273,33,6890
E02001458,4767,1238,888,556,229,43,7721
E02001459,4501,1054,805,507,280,37,7184
E02001460,4285,1172,990,675,359,90,7571
E02001461,3807,1001,812,639,290,44,6593
E02001462,5390,1048,778,502,158,24,7900
E02001463,4498,1008,687,542,289,31,7055
E02001464,4747,946,682,458,154,37,7024
E02001465,4635,1042,822,519,206,43,7267
E02001466,5466,1181,966,682,324,52,8671
E02001467,4218,1246,1116,854,429,82,7945
E02001468,4519,1179,943,606,276,96,7619
E02001469,4080,1181,1088,843,466,107,7765
E02001470,4647,1297,1191,783,398,77,8393
E02001471,5073,1075,796,544,282,56,7826
E02001472,4212,1096,836,521,267,79,7011
E02001473,4791,1082,916,731,337,72,7929
E02001474,5052,969,660,459,183,21,7344
E02001475,4090,828,674,529,245,56,6422
E02001476,5556,998,708,470,204,35,7971
E02001477,5376,966,744,412,164,19,7681
E02001478,4444,1082,1135,867,393,79,8000
E02001479,3314,1008,892,670,254,51,6189
E02001480,3990,1265,1031,794,500,211,7791
E02001481,4508,1285,982,867,365,98,8105
E02001482,5336,1224,882,476,248,27,8193
E02001483,3796,1115,1124,853,373,59,7320
E02001484,4237,1142,1032,921,532,147,8011
E02001485,4482,913,672,506,269,71,6913
E02001486,4032,1260,1148,1042,495,177,8154
E02001487,6954,1230,861,495,156,38,9734
E02001488,5203,1306,882,668,307,56,8422
E02001489,3719,1228,1334,1124,543,137,8085
E02001490,4709,1191,1022,919,346,46,8233
E02001491,4278,885,808,548,283,68,6870
E02001492,4032,1201,992,930,543,134,7832
E02001493,5604,1018,816,546,229,62,8275
E02001494,3257,1144,1086,981,446,129,7043
E02001495,4867,1166,902,653,310,88,7986
E02001496,3447,969,776,649,330,94,6265
E02001497,5216,1157,888,631,265,31,8188
E02001498,4378,1145,864,677,358,61,7483
E02001499,3101,996,989,893,543,99,6621
E02001500,3831,1128,1083,950,467,77,7536
E02001501,4542,1248,963,825,330,95,8003
E02001502,5815,1295,1074,896,427,137,9644
E02001503,3611,1103,1013,1005,574,145,7451
E02001504,3213,1014,1076,1170,617,126,7216
E02001505,3628,914,710,687,336,70,6345
E02001506,3713,1361,1388,1354,803,146,8765
E02001507,3627,1020,890,1044,492,66,7139
E02001508,4824,1241,974,733,453,68,8293
E02001509,3876,1026,839,645,308,64,6758
E02001510,3651,920,708,546,198,26,6049
E02001511,3397,920,884,644,319,51,6215
E02001512,4476,1230,961,856,460,141,8124
E02001513,4120,1257,1013,957,344,35,7726
E02001514,4971,1101,823,573,244,49,7761
E02001515,6458,1336,1089,726,334,47,9990
E02001516,3976,887,632,414,177,37,6123
E02001517,4366,1329,1121,885,401,71,8173
E02001518,6490,1594,1171,861,395,93,10604
E02001519,5280,1078,800,575,255,68,8056
E02001520,6074,1752,1444,1351,700,137,11458
E02001521,8998,1616,1115,713,302,62,12806
E02001522,5497,1285,1067,801,366,74,9090
E02001523,4443,1038,722,665,305,53,7226
E02001524,2811,1091,933,884,371,53,6143
E02001525,4531,910,738,540,253,46,7018
E02001526,4203,817,634,469,212,27,6362
E02001527,3340,969,796,648,309,62,6124
E02001528,6192,1504,1353,1058,484,89,10680
E02001529,5440,1379,1195,921,525,61,9521
E02001530,4316,1056,720,447,168,36,6743
E02001531,4919,1046,889,643,273,51,7821
E02001532,6278,1614,1332,1014,416,98,10752
E02001533,4836,1061,937,590,256,70,7750
E02001534,6275,1396,997,755,359,83,9865
E02001535,3340,1119,976,777,289,59,6560
E02001536,4638,1307,1058,979,474,118,8574
E02001537,5249,1306,1010,656,285,57,8563
E02001538,4651,1227,1062,868,359,64,8231
E02001539,4159,865,654,474,207,23,6382
E02001540,6914,1700,1483,1053,492,86,11728
E02001541,6420,1675,1389,1139,545,109,11277
E02001542,4762,1083,915,667,317,59,7803
E02001543,4557,1165,1037,773,424,73,8029
E02001544,5118,1239,910,803,334,71,8475
E02001545,4220,1275,1267,982,519,79,8342
E02001546,5455,1233,1016,881,438,89,9112
E02001547,7126,1561,1105,730,319,81,10922
E02001548,5383,1143,761,582,232,52,8153
E02001549,3624,887,799,562,298,39,6209
E02001550,4790,1078,900,583,338,66,7755
E02001551,3761,866,734,466,209,25,6061
E02001552,5128,1005,824,545,293,61,7856
E02001553,6605,1345,1118,781,406,84,10339
E02001554,3277,991,720,609,383,40,6020
E02001555,2563,789,898,676,313,50,5289
E02001556,6280,1306,906,648,330,74,9544
E02001557,6803,1433,1098,591,296,99,10320
E02001558,2772,1020,933,893,371,44,6033
E02001559,4225,1194,855,867,394,85,7620
E02001560,10353,1396,868,538,216,51,13422
E02001561,4489,940,655,377,232,43,6736
E02001562,3358,792,749,546,332,102,5879
E02001563,4395,1113,1037,867,496,154,8062
E02001564,4092,1207,1230,1010,381,67,7987
E02001565,3963,1044,1095,825,375,80,7382
E02001566,6875,1181,687,393,189,20,9345
E02001567,5551,1207,1004,727,379,90,8958
E02001568,3991,896,729,629,219,42,6506
E02001569,5631,1305,972,668,321,58,8955
E02001570,4162,1023,843,636,321,53,7038
E02001571,3342,948,826,696,302,50,6164
E02001572,4781,1038,794,564,246,62,7485
E02001573,4917,1052,822,576,333,51,7751
E02001574,3341,907,839,694,256,48,6085
E02001575,4955,988,723,554,280,71,7571
E02001576,4219,993,707,598,264,47,6828
E02001577,2842,951,991,1065,536,82,6467
E02001578,7870,1516,1115,683,318,71,11573
E02001579,5849,1329,1169,875,462,107,9791
E02001580,4550,1191,1053,969,458,91,8312
E02001581,3403,894,821,553,234,51,5956
E02001582,4572,1167,900,704,325,68,7736
E02001583,3585,793,619,433,194,53,5677
E02001584,3522,1137,1024,800,276,64,6823
E02001585,4089,882,707,481,234,41,6434
E02001586,4202,1322,961,877,426,66,7854
E02001587,3395,826,676,563,210,80,5750
E02001588,4508,1019,731,488,341,71,7158
E02001589,4625,1167,984,784,323,57,7940
E02001590,5318,989,682,473,195,26,7683
E02001591,6162,1004,759,451,210,63,8649
E02001592,4875,1359,1106,954,359,53,8706
E02001593,5594,897,641,350,169,28,7679
E02001594,6174,871,608,379,239,79,8350
E02001595,4534,1363,1142,791,402,80,8312
E02001596,4321,1175,1134,1049,561,135,8375
E02001597,5987,1237,1063,740,350,57,9434
E02001598,5356,1464,1145,952,560,86,9563
E02001599,3434,1011,799,725,358,68,6395
E02001600,6947,1380,1168,1013,611,128,11247
E02001601,2567,788,648,545,267,53,4868
E02001602,5190,1300,968,995,436,67,8956
E02001603,4462,1013,818,652,291,48,7284
E02001604,7179,1424,879,700,297,63,10542
E02001605,4594,1176,854,680,349,79,7732
E02001606,4684,1161,943,859,361,56,8064
E02001607,5159,1232,1100,992,403,61,8947
E02001608,4089,967,763,717,229,40,6805
E02001609,4205,1211,1168,1258,466,78,8386
E02001610,4589,1308,1026,1025,403,79,8430
E02001611,4263,1061,935,849,425,119,7652
E02001612,3191,925,715,655,233,63,5782
E02001613,5510,1564,1357,1171,492,85,10179
E02001614,5838,1612,1381,1242,553,99,10725
E02001615,3378,1164,1010,1051,506,83,7192
E02001616,4235,1066,767,771,393,61,7293
E02001617,4162,761,452,294,174,32,5875
E02001618,5757,1547,1139,954,403,53,9853
E02001619,6268,1338,937,769,354,73,9739
E02001620,4765,883,564,485,225,30,6952
E02001621,4166,763,504,392,201,38,6064
E02001622,5794,1152,829,608,402,82,8867
E02001623,5814,1013,766,502,305,72,8472
E02001624,6557,1332,865,762,324,55,9895
E02001625,5254,1025,743,534,251,50,7857
E02001626,3556,851,627,541,240,35,5850
E02001627,4108,812,595,372,202,16,6105
E02001628,5446,577,481,335,216,45,7100
E02001629,4729,858,567,445,311,50,6960
E02001630,7615,911,627,352,292,87,9884
E02001631,4783,1168,705,626,352,79,7713
E02001632,12243,1219,653,369,266,61,14811
E02001633,3731,1152,1037,955,507,96,7478
E02001634,6303,1131,912,621,313,76,9356
E02001635,3419,878,647,707,407,62,6120
E02001636,8602,1010,715,585,348,65,11325
E02001637,6932,637,450,321,173,30,8543
E02001638,5109,350,301,204,100,17,6081
E02001639,4438,586,434,435,255,85,6233
E02001640,6636,515,452,290,187,58,8138
E02001642,6858,1352,877,751,385,75,10298
E02001643,3382,971,808,704,366,79,6310
E02001646,7581,547,450,346,191,50,9165
E02001647,3542,935,658,670,350,92,6247
E02001648,7526,935,692,563,270,104,10090
E02001649,7161,1232,903,621,235,45,10197
E02001650,8885,602,378,210,144,38,10257
E02001651,3978,1284,1049,962,514,91,7878
E02001652,11694,652,433,271,193,29,13272
E02001653,5516,826,518,447,213,40,7560
E02001654,3522,1013,631,629,410,72,6277
E02001655,4883,1056,792,668,271,55,7725
E02001656,5999,884,634,439,239,42,8237
E02001657,5972,1195,918,672,344,58,9159
E02001658,3814,714,475,344,158,44,5549
E02001659,3501,937,687,513,318,65,6021
E02001660,7221,1155,936,569,306,97,10284
E02001661,5510,1002,675,610,316,90,8203
E02001662,4198,1073,853,766,468,86,7444
E02001663,5375,1098,612,370,198,38,7691
E02001664,3568,858,812,677,400,49,6364
E02001665,4933,1526,1251,1115,640,154,9619
E02001666,3688,951,620,475,206,43,5983
E02001669,4979,1081,697,508,272,49,7586
E02001670,4194,828,566,436,275,78,6377
E02001671,2734,956,864,746,310,66,5676
E02001672,3346,890,651,641,443,104,6075
E02001673,3067,926,659,381,188,49,5270
E02001674,4332,1322,1166,1073,590,132,8615
E02001675,4727,1187,1161,1075,437,83,8670
E02001676,2983,941,756,649,355,95,5779
E02001678,5192,1562,1408,1254,742,137,10295
E02001679,4191,882,628,504,273,73,6551
E02001680,4311,792,572,442,263,69,6449
E02001681,4019,1124,1007,921,485,88,7644
E02006803,5189,1436,1074,819,381,36,8935
E02006843,20742,243,106,55,14,11,21171
E02006844,10541,326,188,92,63,13,11223
E02006868,10125,1353,964,717,356,49,13564
E02006869,6633,1761,1062,946,488,159,11049
E02001708,8766,1544,1453,923,400,82,13168
E02001709,5888,1356,1202,988,536,158,10128
E02001710,5971,1325,1100,681,442,110,9629
E02001711,5761,1296,1038,701,445,125,9366
E02001712,5977,1166,1069,744,401,144,9501
E02001713,6060,1510,1190,853,472,144,10229
E02001714,5810,1337,1196,661,364,112,9480
E02001715,7774,1388,1081,714,405,87,11449
E02001718,3724,831,685,490,230,47,6007
E02001719,5142,1159,1015,712,402,90,8520
E02001720,7695,543,493,351,168,49,9299
E02001721,5869,1519,1205,1062,553,113,10321
E02001722,5958,1369,1003,825,663,107,9925
E02001723,4658,744,566,369,244,58,6639
E02001724,7208,548,471,409,253,86,8975
E02001725,8375,732,485,341,184,61,10178
E02001726,8247,1530,1165,756,385,85,12168
E02001727,4820,1284,1089,773,379,50,8395
E02001728,5568,1319,1103,875,439,58,9362
E02001729,12075,940,623,301,181,49,14169
E02001730,18323,868,685,388,144,42,20450
E02001731,19357,913,637,399,230,40,21576
E02001732,3349,700,663,408,181,34,5335
E02001733,8293,1610,1184,784,400,83,12354
E02001734,5780,969,818,577,301,72,8517
E02001735,4590,845,620,411,224,43,6733
E02001736,11445,1304,1025,525,283,56,14638
E02001737,3842,781,583,498,256,77,6037
E02006893,5009,1466,1493,1441,761,102,10272
E02001738,2773,849,898,923,549,64,6056
E02001739,4011,1122,1031,807,303,29,7303
E02001740,3519,870,700,610,300,57,6056
E02001741,3962,1112,1047,969,550,127,7767
E02001742,3083,956,775,698,330,68,5910
E02001743,4678,1196,898,615,235,77,7699
E02001744,4667,1051,803,564,328,82,7495
E02001745,4103,898,737,585,261,32,6616
E02001746,4901,1226,957,747,375,88,8294
E02001747,3043,905,892,802,495,85,6222
E02001748,5741,1061,815,544,231,38,8430
E02001749,3503,944,888,665,312,46,6358
E02001750,3746,997,890,746,409,91,6879
E02001751,3557,909,745,556,313,65,6145
E02001752,4065,789,691,558,290,37,6430
E02001753,3369,948,947,630,336,70,6300
E02001754,3185,895,754,622,329,93,5878
E02001755,5513,1383,993,778,396,112,9175
E02001756,6335,1226,918,604,331,109,9523
E02001757,2973,989,794,638,357,53,5804
E02001758,3260,765,816,534,139,30,5544
E02001759,3549,943,771,562,280,46,6151
E02001760,5319,1085,738,492,221,50,7905
E02001761,2934,785,695,617,304,45,5380
E02001762,3408,923,922,537,195,32,6017
E02001763,3864,899,809,517,235,38,6362
E02001764,4845,1218,951,509,250,53,7826
E02001765,5255,905,807,496,252,75,7790
E02001766,5228,992,714,446,163,18,7561
E02001767,4230,1097,841,523,270,76,7037
E02001768,5270,1229,1030,645,282,62,8518
E02001769,5243,1206,950,572,247,47,8265
E02001770,3719,1030,840,533,300,65,6487
E02001771,3577,956,833,628,428,159,6581
E02001772,3158,755,653,543,315,63,5487
E02001773,2422,904,891,653,352,58,5280
E02001774,3315,846,663,525,171,43,5563
E02001775,3291,797,647,497,278,40,5550
E02001776,5536,1247,997,624,297,85,8786
E02001777,3756,1024,735,491,236,60,6302
E02001778,3568,884,685,497,235,63,5932
E02001779,3352,780,734,506,237,38,5647
E02001780,3335,937,773,627,301,45,6018
E02001781,3273,789,664,397,206,49,5378
E02001782,5828,1326,1161,764,460,102,9641
E02001783,4839,928,731,440,227,45,7210
E02001784,3745,1031,879,607,317,56,6635
E02001785,4015,1238,1118,918,440,66,7795
E02001786,3850,1127,840,569,370,48,6804
E02001787,3038,779,697,661,199,32,5406
E02001788,3322,974,806,484,223,37,5846
E02001789,2683,922,846,751,406,69,5677
E02001790,3465,890,766,608,370,69,6168
E02001791,2779,1009,691,634,353,54,5520
E02001792,3133,1163,983,809,532,86,6706
E02001793,5356,1173,819,511,374,46,8279
E02001794,5396,1195,947,719,433,91,8781
E02001795,4307,1071,1024,658,352,44,7456
E02001796,5598,1400,1222,916,499,57,9692
E02001797,3211,824,817,658,251,40,5801
E02001798,4937,1190,1078,649,335,52,8241
E02001799,6250,1305,1058,661,372,72,9718
E02001800,4039,915,988,705,183,12,6842
E02001801,4813,800,549,332,181,32,6707
E02001802,4570,910,722,481,239,26,6948
E02001803,7492,951,803,466,279,33,10024
E02001804,3917,908,728,626,290,70,6539
E02001805,3035,889,769,600,403,85,5781
E02001806,5187,1129,973,560,295,39,8183
E02001807,5197,1066,876,677,245,27,8088
E02001808,3968,755,609,426,233,35,6026
E02001809,3411,824,999,866,297,34,6431
E02001810,4947,1154,1291,739,211,27,8369
E02001811,5454,1266,1017,785,398,49,8969
E02001812,5050,1546,1514,1209,674,103,10096
E02001813,6442,1406,900,727,300,40,9815
E02001814,3739,893,720,508,286,39,6185
E02001815,5181,1444,1738,1170,383,28,9944
E02001816,3756,1026,935,691,414,72,6894
E02001817,3853,891,803,607,348,70,6572
E02001818,5807,1310,1016,621,374,59,9187
E02001819,3138,1088,1029,916,451,45,6667
E02001820,5657,1324,1055,777,349,42,9204
E02001821,3012,1001,802,491,208,25,5539
E02001822,4433,1254,967,634,280,47,7615
E02001823,4836,1140,813,604,298,41,7732
E02001824,4826,1244,1094,918,489,90,8661
E02001825,3693,1164,968,863,497,49,7234
E02001826,4649,909,834,630,208,29,7259
E02001827,3529,833,724,667,415,103,6271
E02001828,3818,979,743,806,537,123,7006
E02001829,5352,1198,835,866,488,93,8832
E02001830,4764,1427,1186,1142,694,167,9380
E02001831,6429,1408,1012,779,412,126,10166
E02001832,4386,1237,988,825,397,90,7923
E02001833,3414,860,651,540,283,45,5793
E02001834,4157,780,492,366,203,50,6048
E02001835,4837,1181,876,699,445,121,8159
E02001836,5596,1284,1100,878,501,110,9469
E02001837,7330,1324,869,555,289,39,10406
E02001838,3892,1103,1098,771,356,97,7317
E02001839,3984,890,642,547,296,82,6441
E02001840,6617,1168,819,531,284,79,9498
E02001841,2741,820,823,777,335,91,5587
E02001842,4847,1037,695,583,302,52,7516
E02001843,4208,908,627,548,317,53,6661
E02001844,5509,1345,1128,977,659,177,9795
E02001845,4440,930,522,454,141,30,6517
E02001846,5629,1085,705,504,230,44,8197
E02001847,2947,726,771,572,296,69,5381
E02001848,5162,788,523,390,224,67,7154
E02001849,6213,841,634,369,197,32,8286
E02001850,5742,962,666,551,309,45,8275
E02001851,5700,1276,879,643,343,75,8916
E02001852,4953,914,640,423,247,49,7226
E02001854,4988,1082,717,582,312,69,7750
E02001855,6323,1375,865,636,466,85,9750
E02001856,7439,1065,671,338,203,44,9760
E02001857,10540,1795,999,627,299,65,14325
E02001858,6739,1106,764,394,209,37,9249
E02001859,8495,951,642,326,256,53,10723
E02001860,7251,954,603,335,227,53,9423
E02001861,8574,1033,691,337,248,49,10932
E02001862,8073,1248,771,399,306,51,10848
E02001863,6416,718,485,261,191,32,8103
E02001864,4247,613,323,281,116,30,5610
E02001865,8939,1216,772,431,221,61,11640
E02001866,7207,884,515,272,198,39,9115
E02001867,6261,644,425,286,135,28,7779
E02001868,7257,860,615,449,322,58,9561
E02001869,5458,642,383,242,112,20,6857
E02001870,10117,1114,712,438,295,63,12739
E02001871,5491,953,786,611,283,104,8228
E02001872,5024,863,661,509,240,90,7387
E02001873,9486,1113,682,394,209,41,11925
E02001874,8303,835,524,291,163,39,10155
E02001875,7895,811,462,250,184,32,9634
E02001876,13267,672,332,196,130,31,14628
E02001877,9656,892,617,300,260,51,11776
E02001878,7371,779,457,223,195,42,9067
E02001879,8355,987,663,328,263,76,10672
E02001880,7539,1002,658,415,189,44,9847
E02001881,8467,827,533,297,184,52,10360
E02001882,6234,856,667,508,312,68,8645
E02001883,5732,1057,681,498,254,56,8278
E02001884,8568,747,405,206,125,39,10090
E02001886,7945,1006,723,474,231,47,10426
E02001888,4704,744,552,412,255,53,6720
E02001889,7266,720,491,268,190,32,8967
E02001890,8388,1098,736,640,311,71,11244
E02001892,8660,1067,583,409,236,39,10994
E02001893,5488,1106,819,605,404,72,8494
E02001895,6127,1050,800,600,311,84,8972
E02001896,7623,882,527,266,241,29,9568
E02001897,6441,817,536,270,203,55,8322
E02001898,3710,973,666,563,322,50,6284
E02001899,4956,984,858,827,570,141,8336
E02001900,5253,732,577,396,279,70,7307
E02001901,5965,971,683,457,265,78,8419
E02001902,3944,825,627,391,241,37,6065
E02001903,5952,655,489,231,125,23,7475
E02001904,5942,803,530,286,184,38,7783
E02001905,9969,753,556,442,274,87,12081
E02001906,5938,1252,862,654,388,66,9160
E02001907,6210,1391,963,885,498,81,10028
E02001908,7259,692,494,250,195,26,8916
E02001909,6556,732,471,241,193,35,8228
E02001910,5570,678,483,267,175,37,7210
E02001911,6262,895,572,478,216,56,8479
E02001913,6628,755,590,487,253,70,8783
E02001914,4983,747,583,336,207,40,6896
E02001915,8458,1488,1062,734,400,118,12260
E02001916,7412,941,587,415,229,56,9640
E02001918,6070,1188,900,523,249,54,8984
E02001919,4616,768,644,366,276,76,6746
E02001920,5126,877,752,621,193,29,7598
E02001921,5613,879,682,560,281,44,8059
E02001922,17112,281,178,133,75,22,17801
E02001923,7976,1112,891,602,328,86,10995
E02001924,4421,899,628,353,249,48,6598
E02001925,4583,670,674,545,297,96,6865
E02001926,5761,757,590,423,294,78,7903
E02001927,5447,943,679,498,290,86,7943
E02001928,4331,867,766,632,205,51,6852
E02001929,7570,1141,659,465,223,44,10102
E02001930,5462,984,780,419,192,37,7874
E02001931,5177,1031,908,632,354,65,8167
E02001932,5420,870,587,415,240,51,7583
E02001933,4865,938,669,495,237,72,7276
E02001934,4604,869,667,498,263,67,6968
E02001935,4998,975,776,650,418,137,7954
E02001936,3988,875,710,587,320,49,6529
E02001937,5615,970,744,469,302,53,8153
E02001938,5475,1045,708,443,231,63,7965
E02001939,3462,802,747,674,417,104,6206
E02001941,4125,703,568,425,280,53,6154
E02001942,4341,908,706,496,297,64,6812
E02001943,4150,874,617,421,258,37,6357
E02001944,5433,1119,743,571,228,60,8154
E02001945,5349,934,669,420,176,33,7581
E02001946,4474,1056,928,688,363,71,7580
E02001947,4252,736,570,405,260,53,6276
E02001948,4547,1042,745,548,329,77,7288
E02001949,4078,757,519,390,233,72,6049
E02001950,5114,1163,902,702,362,69,8312
E02001951,6097,974,961,605,192,38,8867
E02001952,6313,1175,864,574,249,81,9256
E02001953,4023,955,772,735,400,98,6983
E02001954,5058,832,764,591,222,38,7505
E02001955,4941,858,628,520,331,70,7348
E02001956,4482,921,626,450,227,57,6763
E02001957,4731,1111,782,685,297,71,7677
E02006807,5108,960,791,555,350,58,7822
E02006809,6721,1386,1088,592,387,105,10279
E02006895,8598,533,337,200,116,34,9818
E02006896,6564,391,252,144,74,9,7434
E02006897,7272,599,317,166,66,13,8433
E02006898,6965,610,381,171,58,10,8195
E02006899,7628,456,159,99,21,23,8386
E02006900,12655,1222,933,460,350,52,15672
E02006901,12745,1187,864,443,275,47,15561
E02001958,5542,1057,693,562,236,20,8110
E02001959,4487,867,594,553,324,34,6859
E02001961,6025,1085,675,465,217,31,8498
E02001962,5656,665,478,267,168,27,7261
E02001963,3784,846,762,480,273,68,6213
E02001964,7782,950,782,439,268,33,10254
E02001965,5252,1085,952,663,355,70,8377
E02001966,6335,658,406,229,170,19,7817
E02001967,3814,898,734,842,368,93,6749
E02001968,6392,828,603,344,178,42,8387
E02001969,4983,834,567,422,309,53,7168
E02001970,3773,683,535,608,409,77,6085
E02001971,3936,815,561,500,214,50,6076
E02001972,10097,921,672,347,124,37,12198
E02001973,6884,1016,660,489,187,52,9288
E02001974,6353,1263,877,792,415,86,9786
E02001975,5761,1082,725,506,226,65,8365
E02001976,5113,956,776,611,337,69,7862
E02001977,9460,944,642,433,208,57,11744
E02001978,4911,857,602,382,232,53,7037
E02001979,3595,724,528,548,404,89,5888
E02001980,2962,829,734,872,436,57,5890
E02001981,13899,876,576,300,150,18,15819
E02001982,5979,1020,762,668,356,83,8868
E02001983,5292,1039,784,589,318,72,8094
E02001984,7794,1299,863,600,273,73,10902
E02001985,11685,533,315,203,86,19,12841
E02001986,6071,1029,742,635,318,60,8855
E02001987,5745,498,374,313,178,42,7150
E02001988,15803,627,470,305,145,59,17409
E02001989,4638,726,559,425,180,47,6575
E02001990,5450,1340,1087,861,468,103,9309
E02001991,5342,1160,1131,838,415,123,9009
E02001992,7528,1264,860,710,286,60,10708
E02001993,6048,971,740,569,252,86,8666
E02001994,6127,1013,777,698,350,70,9035
E02001995,8391,821,646,547,292,97,10794
E02001996,5464,790,567,414,208,34,7477
E02001997,4985,1160,1032,923,523,135,8758
E02001998,3458,786,608,617,326,66,5861
E02001999,7605,741,670,612,265,74,9967
E02006805,7064,1020,678,439,265,46,9512
E02002000,4945,1100,859,653,365,53,7975
E02002001,3581,937,652,558,283,57,6068
E02002002,3069,1052,902,1082,621,118,6844
E02002003,5108,1458,973,878,596,80,9093
E02002004,4699,1079,710,568,365,48,7469
E02002005,6776,1108,744,618,263,35,9544
E02002006,4012,946,708,497,291,33,6487
E02002007,4885,1306,936,1113,697,79,9016
E02002008,5181,1443,854,536,259,69,8342
E02002009,5017,784,551,369,185,23,6929
E02002010,5587,977,701,471,299,71,8106
E02002011,2757,874,789,723,370,68,5581
E02002012,5402,1161,797,635,428,73,8496
E02002013,3117,983,862,894,489,117,6462
E02002014,5625,917,615,458,242,50,7907
E02002015,3983,960,680,596,313,59,6591
E02002016,5423,954,749,523,280,41,7970
E02002017,5618,1123,836,702,369,66,8714
E02002018,4488,1354,1064,1233,616,95,8850
E02002019,5192,1058,798,615,324,37,8024
E02002020,5424,1375,1047,1210,576,78,9710
E02002021,5460,964,597,475,221,46,7763
E02002022,5996,1133,851,538,255,49,8822
E02002023,3069,761,612,750,220,33,5445
E02002024,5569,1113,949,773,384,74,8862
E02002025,5183,1222,768,637,350,55,8215
E02002026,3757,1025,874,766,253,33,6708
E02002027,3044,888,864,472,101,32,5401
E02002028,3064,831,720,695,462,102,5874
E02002029,3219,886,738,661,414,92,6010
E02002030,4124,875,671,574,253,54,6551
E02002031,3863,822,752,476,191,42,6146
E02002032,6751,1292,937,777,368,55,10180
E02002033,4741,1058,908,825,383,55,7970
E02002034,4890,1168,914,710,341,75,8098
E02002035,3315,890,879,737,309,120,6250
E02002036,4365,847,685,546,201,50,6694
E02002037,3346,849,802,662,275,45,5979
E02002038,5684,1272,1056,1082,417,67,9578
E02002039,3707,844,686,671,374,121,6403
E02002040,2905,924,905,836,439,93,6102
E02002041,3133,842,759,873,483,90,6180
E02002042,4370,1226,1035,952,507,97,8187
E02002043,5699,1252,908,521,293,59,8732
E02002044,5455,972,631,445,182,45,7730
E02002045,5034,1060,790,563,341,37,7825
E02002046,3970,699,574,287,120,18,5668
E02002047,3955,876,802,700,389,77,6799
E02002048,3591,983,771,663,395,77,6480
E02002049,4012,828,578,506,166,63,6153
E02002051,3985,695,491,355,148,18,5692
E02002052,7998,1447,882,715,399,126,11567
E02002053,4216,998,726,580,305,74,6899
E02002054,3340,772,569,584,297,46,5608
E02002055,6842,1197,996,620,325,83,10063
E02002056,6620,1078,762,566,243,64,9333
E02002057,6564,1243,945,665,335,85,9837
E02002058,8921,1658,1099,606,271,55,12610
E02002059,7432,1455,1086,740,405,88,11206
E02002060,4950,753,552,369,265,26,6915
E02002061,4283,625,549,398,281,57,6193
E02002062,6125,1036,748,536,309,57,8811
E02002063,7410,1164,766,518,271,46,10175
E02002064,8303,1678,1077,851,406,82,12397
E02002065,10259,1325,849,573,338,59,13403
E02002066,5899,924,619,441,202,40,8125
E02002067,3362,734,531,595,306,48,5576
E02002068,11560,1359,708,406,248,39,14320
E02002069,4421,931,664,584,321,37,6958
E02002070,7099,1064,673,559,342,77,9814
E02002071,4301,863,613,568,228,31,6604
E02002072,5653,1200,852,598,307,68,8678
E02002073,5299,1044,683,602,237,57,7922
E02002074,5182,1120,804,650,284,65,8105
E02002075,5625,1157,834,712,341,70,8739
E02002076,8158,1419,786,520,298,57,11238
E02002077,6708,1347,1013,854,419,80,10421
E02002078,3686,914,626,616,313,57,6212
E02002079,5110,1205,883,671,364,94,8327
E02002080,4353,941,699,535,283,63,6874
E02006810,6384,1362,1158,974,508,55,10441
E02002081,2746,864,819,633,301,54,5417
E02002082,4023,711,508,490,112,19,5863
E02002083,3162,1015,730,642,331,93,5973
E02002084,4415,820,615,526,209,42,6627
E02002085,4431,805,602,446,230,56,6570
E02002086,3852,857,544,505,171,36,5965
E02002087,4229,869,477,490,212,26,6303
E02002088,6637,1176,725,757,303,42,9640
E02002089,4615,1172,829,837,312,56,7821
E02002090,3807,838,571,458,220,35,5929
E02002091,4228,1147,714,715,467,164,7435
E02002092,4373,1020,753,694,359,112,7311
E02002093,4107,1017,678,654,369,93,6918
E02002094,3232,965,794,624,455,122,6192
E02002095,5463,1186,1053,907,381,78,9068
E02002096,6025,1267,1108,1121,780,234,10535
E02002097,3861,1203,945,820,362,77,7268
E02002098,5920,1405,934,837,607,153,9856
E02002099,3710,1069,838,741,471,125,6954
E02002101,3564,839,716,639,406,72,6236
E02002102,5399,1238,918,770,524,161,9010
E02002103,3173,929,805,767,393,90,6157
E02002104,3186,1054,891,570,227,36,5964
E02002105,4513,1343,953,940,490,116,8355
E02002106,4939,1357,1250,1371,640,214,9771
E02002107,3148,880,776,573,245,75,5697
E02002108,5451,1545,1197,1066,632,127,10018
E02002109,7099,1574,1019,886,322,56,10956
E02006808,4252,880,642,478,252,61,6565
E02002110,4540,1187,675,572,226,35,7235
E02002111,3699,867,652,652,300,43,6213
E02002112,2899,848,649,653,278,33,5360
E02002113,3818,992,688,556,261,51,6366
E02002114,3073,889,685,785,495,100,6027
E02002115,4053,943,659,687,381,61,6784
E02002116,3389,1039,918,873,418,45,6682
E02002117,3660,1107,838,590,259,52,6506
E02002118,4679,1045,705,552,403,75,7459
E02002119,3346,884,702,583,294,64,5873
E02002120,3568,933,825,534,175,35,6070
E02002121,4528,790,595,482,313,100,6808
E02002122,5113,699,490,347,136,33,6818
E02002123,4144,759,648,629,311,55,6546
E02002124,3770,958,772,818,601,179,7098
E02002125,3860,906,651,520,298,53,6288
E02002126,4734,878,621,397,175,52,6857
E02002127,7442,990,720,446,228,59,9885
E02002128,3132,736,700,639,300,47,5554
E02002129,3307,830,781,637,313,30,5898
E02002130,5053,857,584,423,191,33,7141
E02002131,4021,1254,966,1026,482,89,7838
E02002132,4372,744,743,456,268,57,6640
E02002133,4378,909,758,584,293,45,6967
E02002134,6197,1216,735,558,257,48,9011
E02002135,6302,838,592,347,147,34,8260
E02002136,5640,1066,724,494,221,20,8165
E02002137,3053,930,743,787,510,127,6150
E02002138,4444,814,596,458,291,42,6645
E02002139,8475,1080,752,419,269,65,11060
E02002140,6515,857,676,458,279,41,8826
E02002141,3687,970,676,780,436,39,6588
E02002142,5376,808,601,359,189,31,7364
E02002143,8482,912,652,460,232,23,10761
E02002144,3775,856,868,752,460,72,6783
E02002145,5961,883,611,428,195,23,8101
E02002146,4582,798,600,374,190,82,6626
E02002147,6254,1027,659,563,274,52,8829
E02002148,6654,1715,1103,1037,792,95,11396
E02002149,5611,1439,1132,1014,498,107,9801
E02002150,3575,822,595,410,223,39,5664
E02002151,3734,838,640,388,137,31,5768
E02002152,4389,769,504,367,228,54,6311
E02002153,4184,1096,723,696,526,50,7275
E02002154,4411,879,543,349,207,38,6427
E02002155,4783,647,437,299,134,28,6328
E02002156,4956,1193,931,630,341,95,8146
E02002157,4550,1104,814,641,397,96,7602
E02002158,4133,1014,800,756,493,97,7293
E02002159,4774,777,431,287,126,23,6418
E02002160,4772,1018,757,620,303,33,7503
E02002161,5476,848,477,274,123,41,7239
E02002162,3888,1047,907,951,714,189,7696
E02002163,9632,1497,934,553,340,61,13017
E02002164,6561,660,393,202,129,31,7976
E02002165,5766,990,699,358,245,107,8165
E02002166,6440,1191,880,744,349,59,9663
E02002167,3494,996,840,738,387,84,6539
E02002168,9718,1236,803,438,275,45,12515
E02002169,4626,1210,1149,1006,565,178,8734
E02002170,3919,898,644,467,291,40,6259
E02002171,4654,933,793,686,325,54,7445
E02002174,4453,1129,936,696,342,95,7651
E02002175,5152,922,684,530,247,44,7579
E02002176,4570,989,822,701,308,57,7447
E02002177,7836,1156,876,562,286,47,10763
E02002178,4730,1127,962,738,473,120,8150
E02002179,3586,893,705,606,351,61,6202
E02002180,3899,813,647,566,440,64,6429
E02002181,5741,1002,728,506,265,33,8275
E02002182,4066,806,770,470,253,71,6436
E02006894,10682,1546,1131,779,386,117,14641
E02002183,2228,947,847,901,480,85,5488
E02002184,6443,2019,1595,1511,1097,302,12967
E02002185,3280,871,725,595,338,59,5868
E02002186,7258,1974,1704,1464,732,185,13317
E02002187,3086,920,811,671,409,78,5975
E02002188,4486,1172,903,740,327,71,7699
E02002189,4675,691,681,458,278,82,6865
E02002190,8582,1224,1115,574,329,80,11904
E02002191,7012,1088,770,491,250,50,9661
E02002192,4684,1406,1342,1075,568,101,9176
E02002193,3975,838,623,509,193,47,6185
E02002194,4393,1124,833,679,293,56,7378
E02002195,3167,1038,887,804,346,64,6306
E02002196,3722,1055,804,510,206,36,6333
E02002197,5433,1122,972,778,460,129,8894
E02002198,4481,1185,1094,793,407,79,8039
E02002199,3846,1102,839,656,284,47,6774
E02002200,5126,1280,1032,838,436,123,8835
E02002201,7692,1729,1355,891,416,84,12167
E02002202,4901,992,689,462,262,70,7376
E02002203,5010,995,794,530,249,49,7627
E02002204,6078,1808,1563,1337,640,109,11535
E02002205,5280,1718,1412,1069,369,74,9922
E02002206,5213,1246,982,672,395,48,8556
E02002207,5665,761,590,329,218,45,7608
E02002208,5114,1089,832,594,354,58,8041
E02002209,5315,760,484,295,133,29,7016
E02002210,5260,984,736,509,233,68,7790
E02002211,5455,718,602,343,188,49,7355
E02002212,6689,727,468,233,228,29,8374
E02002213,4169,1178,960,708,281,48,7344
E02002214,4132,748,616,340,188,55,6079
E02002215,8164,901,813,319,231,32,10460
E02002216,7287,834,703,321,190,33,9368
E02002217,7979,857,678,326,229,44,10113
E02002218,7129,1087,882,634,278,45,10055
E02002219,6792,657,459,195,131,22,8256
E02002220,7386,820,543,272,115,36,9172
E02002221,13919,1184,738,289,184,39,16353
E02002222,6582,905,635,419,279,61,8881
E02002223,6518,627,482,201,119,19,7966
E02002224,8925,841,556,249,169,39,10779
E02002225,4849,1264,1039,730,318,55,8255
E02002226,12908,974,677,294,215,38,15106
E02002227,5081,703,440,235,127,19,6605
E02002228,5622,856,615,392,203,53,7741
E02002229,4787,1117,878,576,266,74,7698
E02002230,7988,774,577,184,137,20,9680
E02002231,9461,1456,1183,669,341,67,13177
E02002232,5585,711,578,311,191,47,7423
E02002233,8026,775,544,269,150,29,9793
E02002234,6043,954,639,377,170,37,8220
E02002235,5849,725,526,302,156,19,7577
E02002236,4062,800,590,414,278,42,6186
E02002237,6030,1067,737,494,283,70,8681
E02002238,4299,767,630,380,196,30,6302
E02002239,7623,1547,1000,630,271,48,11119
E02002240,6638,1793,1335,823,367,59,11015
E02002241,8004,1529,1322,774,407,98,12134
E02002242,4442,1141,1052,767,369,72,7843
E02002243,5797,1286,1050,831,349,51,9364
E02002244,3435,948,792,702,282,59,6218
E02002245,3640,792,501,354,123,18,5428
E02002246,5046,1556,1316,1049,522,92,9581
E02002247,4817,1829,1345,885,298,69,9243
E02002248,5029,1144,828,584,223,19,7827
E02002249,3862,723,508,382,125,30,5630
E02002250,4561,1432,1212,926,369,61,8561
E02002251,5602,1211,825,613,373,105,8729
E02002252,4067,928,787,652,291,62,6787
E02002253,6717,868,608,339,253,52,8837
E02002254,3416,1058,793,633,297,85,6282
E02002255,6360,634,523,266,229,77,8089
E02002256,5690,1439,1120,867,328,110,9554
E02002257,5361,604,514,229,104,19,6831
E02002258,5387,1461,1129,785,387,69,9218
E02002259,4393,933,762,590,348,95,7121
E02002260,5650,1387,1108,844,327,53,9369
E02002261,4927,1239,990,728,378,42,8304
E02002262,4376,1291,884,885,413,102,7951
E02002263,3732,1011,888,640,196,43,6510
E02002264,3977,1023,817,773,405,90,7085
E02002265,3124,933,761,575,225,86,5704
E02002266,3121,883,723,693,308,59,5787
E02002267,4499,1237,965,864,297,72,7934
E02002268,6499,1486,1126,927,489,98,10625
E02002269,5498,1507,1228,900,306,83,9522
E02002270,5069,1483,1122,791,226,37,8728
E02002271,4245,1026,796,710,401,105,7283
E02002272,5937,1370,1056,902,351,73,9689
E02002273,3988,1031,769,658,284,63,6793
E02002274,4206,1124,838,703,327,62,7260
E02002275,5189,1213,912,798,401,89,8602
E02002276,4637,1027,790,710,335,51,7550
E02002277,4712,837,546,502,258,43,6898
E02002278,4205,910,749,648,226,63,6801
E02002279,3833,912,668,550,232,48,6243
E02002280,5105,684,609,380,189,29,6996
E02002281,7811,1386,1129,823,467,93,11709
E02002282,5764,735,594,368,167,37,7665
E02002283,5480,792,731,389,169,24,7585
E02002284,3592,934,724,541,291,51,6133
E02002285,4570,1281,1009,834,399,69,8162
E02002286,4741,743,590,333,140,34,6581
E02002287,5407,874,573,354,205,50,7463
E02002288,6398,1359,923,708,346,79,9813
E02002289,5596,639,432,226,99,20,7012
E02002290,3369,927,841,831,371,48,6387
E02002291,3772,979,728,773,284,68,6604
E02002292,3181,898,785,542,266,80,5752
E02002293,7540,758,516,276,133,29,9252
E02002294,8249,1107,934,455,215,45,11005
E02002295,5215,937,584,406,171,26,7339
E02002296,3749,1022,763,827,481,110,6952
E02002297,4001,944,834,688,329,67,6863
E02002298,3791,1057,852,665,317,63,6745
E02002299,5881,720,488,274,177,29,7569
E02002300,4812,1045,899,762,446,93,8057
E02002301,6565,801,587,294,189,40,8476
E02002302,3535,1030,740,682,244,47,6278
E02002303,3941,948,682,561,367,96,6595
E02002304,4822,807,594,402,227,51,6903
E02002305,4233,844,598,339,203,35,6252
E02002306,3279,1013,913,591,281,45,6122
E02002307,3346,992,663,578,267,58,5904
E02002308,3974,934,718,531,239,54,6450
E02002309,5068,742,568,380,245,59,7062
E02002310,3828,796,551,507,243,63,5988
E02002311,4005,975,768,514,221,59,6542
E02002312,9082,777,563,342,154,35,10953
E02002313,6631,771,485,288,150,26,8351
E02002314,3183,904,710,667,347,90,5901
E02002315,4520,956,709,416,182,46,6829
E02002316,3448,1012,852,792,333,68,6505
E02002317,5079,887,684,492,294,46,7482
E02002318,3682,936,757,677,279,74,6405
E02002319,4217,964,742,545,261,56,6785
E02002320,3161,980,882,728,365,57,6173
E02002321,4109,972,848,712,265,51,6957
E02002322,3476,1129,877,668,228,51,6429
E02002323,4554,1347,1080,964,452,60,8457
E02002324,3584,985,881,893,303,80,6726
E02002325,4922,1415,1093,1002,422,98,8952
E02002326,3492,1018,747,688,271,42,6258
E02002327,5400,1607,1298,1100,480,105,9990
E02002328,3642,1228,1015,763,345,83,7076
E02002329,6701,2050,1734,1252,419,67,12223
E02002330,3095,977,974,1014,467,45,6572
E02002331,3932,877,708,817,568,127,7029
E02002332,3332,958,773,700,317,63,6143
E02002333,3969,1109,1074,921,438,126,7637
E02002334,3709,965,927,967,473,69,7110
E02002335,3889,1138,1005,963,425,80,7500
E02002336,3480,1041,837,746,427,65,6596
E02002337,4396,1072,810,700,360,50,7388
E02002338,4087,876,725,690,353,86,6817
E02002339,3249,760,616,457,218,51,5351
E02002340,3017,770,737,667,296,67,5554
E02002341,3983,963,910,795,475,92,7218
E02002342,3032,756,713,622,401,55,5579
E02002343,3524,817,632,470,237,37,5717
E02002344,4402,960,903,752,461,88,7566
E02002345,3059,796,758,617,328,77,5635
E02002346,3794,718,588,454,252,36,5842
E02002347,4207,774,586,428,221,62,6278
E02002348,3857,782,714,485,285,93,6216
E02002349,3641,703,624,458,266,60,5752
E02002350,3514,774,597,665,406,78,6034
E02002351,2702,845,745,644,367,43,5346
E02002352,4698,981,830,570,279,58,7416
E02002353,3869,830,628,338,219,55,5939
E02002354,4928,980,780,582,334,98,7702
E02002356,5393,1076,785,690,325,55,8324
E02002357,5208,903,753,604,371,76,7915
E02002358,4855,956,907,731,305,47,7801
E02002359,3402,987,802,790,394,74,6449
E02002360,4530,838,629,388,263,48,6696
E02002361,3902,803,574,313,224,70,5886
E02002362,5274,980,722,467,248,53,7744
E02002363,4554,831,598,395,273,67,6718
E02002364,3586,802,608,391,237,84,5708
E02002366,5353,893,711,600,400,110,8067
E02002367,4513,717,448,292,161,42,6173
E02002368,5213,1109,823,744,344,48,8281
E02002369,5033,960,647,423,237,45,7345
E02002370,4884,812,630,458,213,55,7052
E02002371,7552,1173,799,393,251,47,10215
E02002373,8688,269,238,181,99,44,9519
E02002374,5020,642,561,385,194,33,6835
E02002375,4637,722,511,264,120,17,6271
E02002376,6116,809,430,263,150,20,7788
E02002377,6530,596,406,198,122,11,7863
E02002379,4063,657,408,296,111,23,5558
E02002380,3052,762,615,435,259,38,5161
E02002381,4032,758,648,398,189,26,6051
E02002382,7415,640,295,139,75,15,8579
E02002383,7944,221,179,88,28,7,8467
E02002384,11698,653,475,268,143,17,13254
E02002385,7653,433,347,216,91,17,8757
E02002386,4480,1214,1157,1041,522,125,8539
E02002387,3909,771,448,350,183,37,5698
E02002388,5521,851,582,394,213,55,7616
E02002389,5049,843,633,432,264,53,7274
E02002390,4039,926,656,454,220,50,6345
E02002391,4757,1038,770,513,286,48,7412
E02002392,10831,273,208,104,44,8,11468
E02002393,7606,799,457,227,124,19,9232
E02002394,6509,881,456,323,131,21,8321
E02002395,4485,837,660,492,317,51,6842
E02002396,5896,1118,805,571,321,64,8775
E02002397,4682,1099,768,617,277,51,7494
E02002398,3789,1065,920,842,492,70,7178
E02002399,4279,745,555,339,184,19,6121
E02002400,6771,925,563,351,180,19,8809
E02002401,4729,749,541,370,160,21,6570
E02002402,2962,961,680,526,272,26,5427
E02002403,3357,813,621,694,397,103,5985
E02002404,8860,835,604,376,106,27,10808
E02002405,5420,1133,886,726,456,82,8703
E02002406,3728,958,873,888,383,39,6869
E02002407,4668,769,482,334,179,55,6487
E02002408,4476,960,788,618,289,81,7212
E02002409,3634,858,642,474,243,34,5885
E02002410,4187,939,702,512,263,48,6651
E02002411,7072,812,464,279,160,28,8815
E02002412,4626,939,635,507,265,32,7004
E02002414,5147,679,448,328,176,39,6817
E02002415,6179,741,406,147,80,5,7558
E02002416,3646,982,759,914,425,58,6784
E02002417,3979,855,767,716,304,50,6671
E02002418,4175,953,814,690,233,38,6903
E02002419,5835,943,706,459,264,46,8253
E02002420,6068,985,680,501,275,39,8548
E02002421,4237,767,521,321,161,34,6041
E02002422,3644,837,748,588,263,44,6124
E02002423,3734,764,619,392,173,38,5720
E02002424,4640,1161,760,628,284,49,7522
E02002425,4776,1166,995,913,408,84,8342
E02002426,4464,1155,801,722,446,64,7652
E02002427,3819,953,797,728,355,64,6716
E02002428,5393,1018,719,475,257,26,7888
E02002429,5133,1140,845,766,356,45,8285
E02002430,5590,911,569,424,180,28,7702
E02002431,5736,1067,699,523,203,36,8264
E02002432,4344,1041,757,670,300,56,7168
E02002433,3969,932,675,525,297,37,6435
E02002434,7349,1326,705,494,163,29,10066
E02002435,4712,1055,737,664,327,63,7558
E02002436,4077,992,685,567,238,37,6596
E02002437,3435,1037,800,516,217,43,6048
E02006852,8371,1137,962,691,375,84,11620
E02006861,12742,411,295,232,162,51,13893
E02006875,13120,272,124,63,8,10,13597
E02006876,6765,666,467,306,158,52,8414
E02002438,5731,1136,879,623,255,60,8684
E02002439,5218,1307,863,639,343,82,8452
E02002440,4872,1116,924,684,310,67,7973
E02002441,5990,1266,852,790,368,81,9347
E02002442,4341,1258,837,558,263,46,7303
E02002443,3827,1001,751,510,175,25,6289
E02002444,3763,974,765,562,215,36,6315
E02002445,4617,1136,855,840,361,111,7920
E02002446,3082,961,836,668,272,71,5890
E02002447,3713,921,715,574,299,53,6275
E02002448,4949,1172,884,643,358,55,8061
E02002449,5795,1357,897,740,317,88,9194
E02002450,4515,1147,783,619,238,37,7339
E02002451,4024,1224,1081,862,450,91,7732
E02002452,5384,1242,882,714,311,61,8594
E02002453,6219,1370,1040,806,287,66,9788
E02002454,6215,991,718,422,285,72,8703
E02002455,4120,886,618,488,222,57,6391
E02002456,5406,1136,795,535,158,26,8056
E02002457,5356,1032,818,556,240,73,8075
E02002458,5421,1261,1065,908,399,79,9133
E02002459,6488,1385,894,645,252,67,9731
E02002460,3620,1011,1038,836,499,97,7101
E02002461,7424,1559,1155,894,401,57,11490
E02002462,4286,1083,930,815,334,67,7515
E02002463,7123,1251,825,658,325,78,10260
E02002464,5385,1205,952,737,356,58,8693
E02002465,3248,970,801,657,338,54,6068
E02002466,5267,1309,1139,1015,440,85,9255
E02002467,6585,1061,733,431,187,36,9033
E02002468,3550,886,770,641,309,80,6236
E02002469,3633,995,799,732,255,24,6438
E02002470,2738,977,900,997,477,82,6171
E02002471,6037,1697,1556,1217,576,100,11183
E02002472,3133,953,846,673,251,55,5911
E02002473,3525,1034,955,766,328,39,6647
E02002474,4139,974,767,516,267,50,6713
E02002475,3370,966,874,754,329,78,6371
E02002476,4185,881,626,474,228,38,6432
E02002477,3854,958,801,572,297,74,6556
E02002478,3883,970,700,495,213,36,6297
E02002479,4671,1229,1108,920,355,94,8377
E02002480,3231,810,813,632,278,34,5798
E02002481,4602,1000,781,550,308,72,7313
E02002482,4676,920,737,579,252,45,7209
E02001682,4808,1238,989,864,455,88,8442
E02001683,4903,1494,1157,933,463,104,9054
E02001684,4186,855,780,490,274,57,6642
E02001685,5239,1059,787,684,340,67,8176
E02001686,3420,1103,886,785,411,66,6671
E02001688,5477,910,693,454,231,41,7806
E02001689,6345,886,750,513,259,75,8828
E02001690,4166,1119,872,665,336,63,7221
E02001691,7197,1014,656,390,254,47,9558
E02001692,4381,865,614,366,184,22,6432
E02001693,3260,836,672,507,308,61,5644
E02001694,3741,1040,760,598,289,31,6459
E02001695,3305,939,898,581,336,79,6138
E02001696,5615,1229,1093,712,432,72,9153
E02001697,4192,1181,910,701,332,88,7404
E02001698,3146,945,1018,1202,626,74,7011
E02001699,3734,1014,919,627,355,48,6697
E02001700,5675,1591,1316,1011,531,69,10193
E02001701,3215,1001,788,786,430,90,6310
E02001702,4900,1156,840,593,359,60,7908
E02001703,2663,915,726,742,371,65,5482
E02001704,3885,1170,631,674,424,59,6843
E02001705,3820,1047,968,724,337,73,6969
E02001706,4907,996,859,681,291,58,7792
E02001707,4447,1194,959,916,483,111,8110
E02006841,7698,734,579,398,173,30,9612
E02006842,3700,623,487,352,265,73,5500
E02000001,6206,1339,1025,720,313,118,9721
E02000002,5621,835,505,401,268,105,7735
E02000003,8062,1272,886,575,301,78,11174
E02000004,4401,866,598,444,262,116,6687
E02000005,7982,1144,629,413,211,53,10432
E02000007,7407,1193,659,446,256,87,10048
E02000008,9311,1511,935,552,303,50,12662
E02000009,9321,1216,734,338,188,32,11829
E02000010,6817,1175,605,334,205,68,9204
E02000011,5024,870,492,330,217,61,6994
E02000012,8428,1196,820,481,282,84,11291
E02000013,6717,976,668,385,161,41,8948
E02000014,7237,1184,781,462,227,58,9949
E02000015,6191,921,566,305,172,35,8190
E02000016,8705,748,345,159,56,8,10021
E02000017,7243,869,618,315,202,28,9275
E02000018,7503,992,604,326,183,41,9649
E02000019,6933,1049,643,370,140,39,9174
E02000020,10609,1345,676,416,233,76,13355
E02000021,6698,983,619,385,214,45,8944
E02000022,6956,656,355,147,55,14,8183
E02000023,6616,767,377,150,98,16,8024
E02006799,8356,1260,765,441,248,68,11138
E02000024,6537,1595,1284,952,530,159,11057
E02000025,5201,1242,864,640,320,80,8347
E02000026,3972,928,759,573,302,59,6593
E02000027,6161,1383,1004,673,356,61,9638
E02000028,4425,935,641,456,277,75,6809
E02000029,6513,1237,820,564,263,54,9451
E02000030,5009,1490,1148,906,542,146,9241
E02000031,4810,1024,771,664,426,161,7856
E02000032,4643,1203,865,669,343,48,7771
E02000033,5755,1307,870,560,335,76,8903
E02000034,6153,1229,846,712,323,93,9356
E02000035,6149,1022,768,633,383,122,9077
E02000036,7958,1441,1010,753,375,108,11645
E02000037,7054,1126,1061,836,371,104,10552
E02000038,7722,1571,1037,661,343,145,11479
E02000039,4721,1007,650,544,288,45,7255
E02000040,5764,974,771,583,275,85,8452
E02000041,6894,1138,920,578,374,130,10034
E02000042,8594,1417,954,708,445,129,12247
E02000043,5525,977,772,535,320,77,8206
E02000044,6322,1173,719,455,169,38,8876
E02000045,7819,1434,849,570,231,42,10945
E02000046,5516,893,544,396,223,51,7623
E02000047,8993,1526,938,617,284,64,12422
E02000048,7134,1285,986,776,413,113,10707
E02000049,7207,1157,627,344,124,17,9476
E02000050,7692,1287,950,690,303,88,11010
E02000051,6509,1143,835,746,517,122,9872
E02000052,7565,1199,884,625,282,58,10613
E02000053,13424,1596,923,457,228,57,16685
E02000054,5462,911,641,404,205,25,7648
E02000055,8702,1257,887,590,399,159,11994
E02000056,6090,1207,892,854,410,156,9609
E02000057,6219,719,523,425,215,64,8165
E02000058,7336,1186,986,906,427,110,10951
E02000059,8586,1431,946,536,310,64,11873
E02000060,9277,1018,855,563,435,205,12353
E02000061,6386,1040,751,501,380,117,9175
E02000062,5192,859,524,281,145,20,7021
E02000063,5578,1036,675,403,203,60,7955
E02000064,4989,812,540,357,182,47,6927
E02000065,6695,1193,602,267,160,34,8951
E02000066,7219,1360,799,531,210,63,10182
E02000067,7762,1191,717,497,237,50,10454
E02000068,6156,964,553,293,187,50,8203
E02000069,4591,860,620,475,304,61,6911
E02000070,4869,1202,853,684,390,81,8079
E02000071,5060,1071,758,453,235,69,7646
E02000072,9898,1598,766,477,247,53,13039
E02000073,6534,1633,1141,951,516,84,10859
E02000074,5841,1196,786,536,257,67,8683
E02000075,4532,1223,999,886,475,106,8221
E02000077,5244,1170,800,566,362,72,8214
E02000078,4903,1031,871,654,371,92,7922
E02000079,5516,1085,809,646,557,155,8768
E02000080,6601,1374,1052,750,437,124,10338
E02000081,4882,1132,807,717,408,140,8086
E02000082,5902,1267,913,685,380,81,9228
E02000083,7992,1540,876,749,326,85,11568
E02000084,6743,1573,1232,922,515,96,11081
E02000085,5123,1112,783,626,338,62,8044
E02000086,4271,1151,845,662,310,42,7281
E02000087,4663,1215,812,752,490,101,8033
E02000088,4807,1041,828,694,339,89,7798
E02000089,4648,1148,814,629,434,131,7804
E02000090,5999,1139,824,775,531,215,9483
E02000091,5769,1413,972,935,691,197,9977
E02000092,4434,899,653,457,266,74,6783
E02006785,4128,944,680,515,324,60,6651
E02000093,7482,1248,1157,714,362,96,11059
E02000094,6468,1070,873,560,257,49,9277
E02000095,6472,1163,1030,667,387,175,9894
E02000096,4490,793,925,766,393,87,7454
E02000097,6045,1127,942,538,311,64,9027
E02000098,5633,987,837,545,299,46,8347
E02000099,6303,1042,720,407,301,99,8872
E02000100,5699,984,997,657,311,77,8725
E02000101,6524,1203,828,598,336,73,9562
E02000102,5321,971,674,390,188,33,7577
E02000103,6385,1224,744,495,308,76,9232
E02000104,4744,858,739,487,342,85,7255
E02000105,6973,1144,830,485,276,38,9746
E02000106,7647,1323,896,500,264,64,10694
E02000107,8509,1276,924,585,213,44,11551
E02000108,4541,764,634,395,189,33,6556
E02000109,10373,1278,933,561,299,80,13524
E02000110,6087,962,817,475,201,36,8578
E02000111,7669,1344,1057,514,288,74,10946
E02000112,7285,1370,1044,447,313,71,10530
E02000113,6791,1347,827,420,220,41,9646
E02000114,7507,1018,741,433,219,50,9968
E02000115,6285,1003,713,417,249,49,8716
E02000116,7179,1079,630,329,161,29,9407
E02000117,9088,1742,1066,557,363,52,12868
E02000118,7301,1423,938,468,271,44,10445
E02000119,6652,1150,623,401,200,34,9060
E02000120,6835,1021,713,467,186,25,9247
E02000121,7754,1200,968,526,267,46,10761
E02000122,5039,1056,778,489,273,75,7710
E02000123,11423,2109,1193,543,292,55,15615
E02000124,7291,1188,768,497,222,40,10006
E02000125,7008,1374,892,491,317,74,10156
E02000126,5611,1003,571,360,186,29,7760
E02000127,6519,1232,770,505,304,66,9396
E02000128,4971,1084,699,646,314,49,7763
E02000130,6025,1186,748,538,221,39,8757
E02000131,8492,1114,574,362,121,24,10687
E02000132,7227,1175,792,621,347,101,10263
E02000133,6229,1602,1040,931,627,191,10620
E02000134,8514,1452,1027,698,312,96,12099
E02000135,7789,1396,805,394,231,75,10690
E02000136,3356,809,582,530,392,119,5788
E02000137,5324,1104,824,735,421,131,8539
E02000138,4847,1185,925,870,581,143,8551
E02000139,5571,1063,700,407,203,48,7992
E02000140,6219,1181,622,526,222,63,8833
E02000141,5213,1001,622,383,203,27,7449
E02000142,5682,1207,827,668,370,98,8852
E02000144,6967,1260,734,662,337,64,10024
E02000145,6540,1105,671,532,237,37,9122
E02000146,6477,1246,793,607,372,129,9624
E02000147,4741,1318,943,759,403,88,8252
E02000148,3902,997,753,671,349,77,6749
E02000149,5304,1187,747,581,307,57,8183
E02000150,5362,1428,847,632,359,75,8703
E02000151,4451,1065,852,819,374,86,7647
E02000152,5476,1090,637,470,268,62,8003
E02000153,4663,1246,844,689,335,69,7846
E02000154,5194,1159,953,765,366,80,8517
E02000155,3700,1066,843,767,491,63,6930
E02000156,6763,1843,1474,1154,771,212,12217
E02000157,4649,1193,862,829,581,95,8209
E02000158,4756,1126,747,731,401,102,7863
E02000159,3793,1128,791,740,416,92,6960
E02000160,4534,1393,837,751,411,102,8028
E02000161,5456,1150,890,829,385,78,8788
E02000162,3860,1034,710,773,477,149,7003
E02000163,4305,1165,941,788,452,70,7721
E02000165,4270,1033,837,597,223,17,6977
E02006782,4984,1165,831,640,350,81,8051
E02006787,5335,1151,807,531,274,50,8148
E02006789,3239,1068,823,957,366,39,6492
E02000166,5638,1290,1069,853,396,74,9320
E02000167,6216,1258,833,826,420,131,9684
E02000168,6684,1211,864,624,252,52,9687
E02000169,6724,1143,701,677,387,139,9771
E02000170,7370,1040,739,535,251,58,9993
E02000171,6566,1169,799,630,271,78,9513
E02000172,9176,1412,827,590,298,99,12402
E02000173,7671,968,687,515,312,77,10230
E02000174,7653,1220,843,492,233,26,10467
E02000175,9243,935,749,515,216,43,11701
E02000176,5645,924,548,543,216,64,7940
E02000177,7583,1105,714,594,325,137,10458
E02000178,8218,1044,706,476,198,31,10673
E02000179,5298,846,602,515,263,72,7596
E02000180,7836,992,678,426,182,47,10161
E02000181,7261,876,635,416,234,64,9486
E02000182,6599,973,567,508,286,141,9074
E02000183,5796,1158,894,688,281,68,8885
E02000184,8605,1034,606,348,185,41,10819
E02000185,7171,1107,914,642,271,86,10191
E02000186,6403,918,547,398,183,51,8500
E02000187,9086,1043,732,432,253,52,11598
E02000188,7041,859,577,328,215,40,9060
E02000189,5786,610,429,225,148,29,7227
E02000190,6933,748,633,427,191,42,8974
E02000191,7217,706,485,319,121,37,8885
E02000192,6390,1147,788,407,196,68,8996
E02000193,6255,983,729,544,173,54,8738
E02000194,6789,1232,747,448,212,63,9491
E02000195,6341,1403,1059,635,362,72,9872
E02000196,5332,1097,814,489,286,37,8055
E02000197,6577,1279,872,553,303,58,9642
E02000198,6249,1261,692,341,183,31,8757
E02000199,5647,1364,787,339,178,27,8342
E02000200,6163,1260,704,427,261,71,8886
E02000201,6883,1245,618,306,198,24,9274
E02000202,5533,1322,803,481,302,42,8483
E02000203,5643,1095,718,394,230,26,8106
E02000204,6646,1327,916,498,267,57,9711
E02000206,7297,1321,813,414,299,80,10224
E02000207,6411,1383,763,386,176,19,9138
E02000208,8446,1250,695,338,169,46,10944
E02000209,6330,1205,736,296,179,35,8781
E02000210,5870,1279,717,364,196,28,8454
E02000211,4442,1289,997,820,425,95,8068
E02000212,7021,1227,634,307,164,14,9367
E02000213,8964,1308,690,353,142,18,11475
E02000214,3629,1020,786,465,265,52,6217
E02000215,8444,1393,829,549,303,70,11588
E02000216,4635,741,657,564,377,122,7096
E02000217,9752,1369,712,355,163,40,12391
E02000218,4239,969,730,404,216,48,6606
E02000219,3602,1244,1063,944,471,138,7462
E02000220,10714,1160,743,442,231,102,13392
E02000221,7600,1437,798,551,280,114,10780
E02000222,5858,1028,700,486,231,35,8338
E02000223,6453,1072,478,344,211,27,8585
E02000224,5776,1012,634,416,220,34,8092
E02000225,4917,1121,742,498,212,39,7529
E02000226,4066,1202,1007,761,404,87,7527
E02000227,7013,1626,1340,971,421,86,11457
E02000228,4205,1146,982,866,455,129,7783
E02000229,4508,1010,576,371,191,73,6729
E02000230,6634,1515,1094,802,444,129,10618
E02000231,4075,1211,1075,728,404,90,7583
E02000232,3500,945,772,640,348,62,6267
E02000233,4222,824,600,384,259,89,6378
E02000234,5768,1257,886,650,321,66,8948
E02000235,4143,1081,824,587,264,67,6966
E02000236,5110,1149,916,646,249,66,8136
E02000237,4073,1194,946,854,407,115,7589
E02006788,5212,1179,640,352,174,26,7583
E02000238,6597,1180,815,520,213,39,9364
E02000239,5746,1121,913,612,308,67,8767
E02000240,7139,1239,832,509,265,57,10041
E02000241,4613,857,635,372,193,40,6710
E02000242,4728,829,676,359,198,34,6824
E02000243,5668,1043,811,486,373,32,8413
E02000244,5211,886,698,453,241,31,7520
E02000245,5992,1069,636,338,225,49,8309
E02000246,5954,1122,764,407,237,61,8545
E02000247,7438,1171,884,533,374,122,10522
E02000248,5563,909,606,380,240,40,7738
E02000249,4987,928,645,473,309,77,7419
E02000250,3772,859,756,517,264,57,6225
E02000251,4790,1024,780,455,286,22,7357
E02000252,9277,1019,727,381,222,40,11666
E02000253,6214,1183,843,597,350,70,9257
E02000254,5496,1122,918,541,234,74,8385
E02000255,5939,1228,888,635,338,105,9133
E02000256,6250,1101,737,474,265,58,8885
E02000257,10524,1601,1142,792,435,128,14622
E02000258,5166,745,554,337,179,49,7030
E02000259,4015,779,639,346,163,42,5984
E02000260,6250,1193,990,558,373,59,9423
E02000261,9134,1287,790,561,262,66,12100
E02000262,6261,1141,688,433,208,66,8797
E02000263,8261,1546,1135,640,379,90,12051
E02000264,5765,1052,756,517,288,74,8452
E02000265,7625,1303,750,578,264,62,10582
E02000266,8145,1511,981,511,307,70,11525
E02000267,5076,967,603,335,194,47,7222
E02000268,5895,1229,848,589,300,52,8913
E02000269,5309,1064,729,445,211,68,7826
E02000270,5792,910,565,330,200,48,7845
E02000271,4595,1036,614,435,169,43,6892
E02000272,4044,937,657,479,268,49,6434
E02000274,10246,1834,1193,606,267,45,14191
E02000275,4980,967,788,501,284,58,7578
E02000276,4663,767,536,321,155,30,6472
E02006791,4767,910,561,406,128,15,6787
E02000277,5342,1033,587,430,235,43,7670
E02000278,7097,1226,618,485,262,69,9757
E02000279,10001,1589,820,428,203,21,13062
E02000280,5411,1181,864,660,306,85,8507
E02000281,6506,1232,659,504,261,59,9221
E02000282,7469,1234,638,448,161,16,9966
E02000283,6245,1231,679,427,221,51,8854
E02000284,5771,1124,792,601,288,70,8646
E02000285,3776,1057,706,548,285,51,6423
E02000286,5064,1102,946,789,480,131,8512
E02000287,4180,1011,812,700,372,122,7197
E02000288,8375,1419,795,490,275,50,11404
E02000289,3682,1031,707,681,386,62,6549
E02000290,5200,727,465,246,157,20,6815
E02000291,7138,1205,818,570,429,123,10283
E02000292,6853,1318,805,512,299,40,9827
E02000293,3653,1009,727,621,350,91,6451
E02000294,6574,1291,777,531,288,42,9503
E02000295,5910,1142,747,600,425,123,8947
E02000296,7303,1270,786,650,438,120,10567
E02000297,5711,1349,1097,857,460,112,9586
E02000298,4867,1260,848,649,359,77,8060
E02000299,7368,1307,804,403,234,46,10162
E02000300,6550,1116,724,421,213,41,9065
E02000301,8084,1314,748,474,238,49,10907
E02000302,5584,1150,859,634,266,59,8552
E02000303,6680,1147,695,417,202,38,9179
E02000304,4763,1250,891,699,376,99,8078
E02000305,6106,1179,813,514,270,84,8966
E02000306,6847,1111,635,401,211,33,9238
E02000307,6899,1354,925,557,297,48,10080
E02000308,6093,985,670,512,230,31,8521
E02000309,9452,1502,829,401,193,33,12410
E02000311,7641,1285,958,643,280,56,10863
E02000312,8427,1442,911,580,349,65,11774
E02006793,7775,1199,640,328,203,47,10192
E02000313,5511,1051,552,274,69,13,7470
E02000314,13098,1870,723,283,78,22,16074
E02000315,7059,1259,670,366,224,71,9649
E02000316,12603,1255,731,369,129,42,15129
E02000317,6146,989,551,322,130,28,8166
E02000318,7664,1296,771,519,238,32,10520
E02000319,9175,1285,710,344,150,37,11701
E02000320,5299,950,614,318,119,30,7330
E02000321,5687,930,602,322,114,48,7703
E02000323,8827,1218,683,364,192,47,11331
E02000324,5742,902,627,399,216,48,7934
E02000326,5510,856,559,340,159,33,7457
E02000327,5625,868,389,165,70,12,7129
E02000328,4697,749,624,483,258,59,6870
E02000329,4276,860,657,378,200,50,6421
E02000331,6179,967,573,378,211,56,8364
E02000332,5111,1049,714,495,200,50,7619
E02000333,4434,738,491,484,250,87,6484
E02000334,4437,938,628,384,194,38,6619
E02000335,4328,946,686,526,283,63,6832
E02000337,5540,1176,743,542,226,38,8265
E02000339,3864,847,724,505,286,81,6307
E02000340,4195,802,643,577,358,92,6667
E02000341,5809,1047,642,470,211,39,8218
E02000342,4468,698,508,306,176,52,6208
E02000343,4491,965,663,492,239,66,6916
E02000344,4150,858,654,560,261,64,6547
E02006786,5254,1076,592,378,147,12,7459
E02006927,7259,1226,818,721,347,91,10462
E02006928,10623,786,438,235,45,12,12139
E02006929,10934,957,582,316,196,34,13019
E02006930,7425,741,473,305,167,16,9127
E02006931,7267,1024,672,510,255,78,9806
E02000345,7977,674,515,353,127,33,9679
E02000346,6273,855,581,286,145,37,8177
E02000347,7046,774,512,313,155,58,8858
E02000348,7246,847,556,229,134,39,9051
E02000350,8136,957,529,306,105,22,10055
E02000351,8033,882,489,277,135,37,9853
E02000352,5423,789,499,292,163,66,7232
E02000353,6216,902,529,311,184,39,8181
E02000354,8257,1135,666,413,159,31,10661
E02000355,7016,1005,617,344,233,45,9260
E02000356,5691,894,455,243,112,16,7411
E02000357,4697,757,568,342,160,29,6553
E02000358,9371,1182,686,427,205,43,11914
E02000359,5117,747,390,271,131,24,6680
E02000360,9306,1307,868,373,253,38,12145
E02000361,7380,877,500,227,129,23,9136
E02000362,5850,783,462,246,121,30,7492
E02000363,9127,1364,751,367,214,55,11878
E02000364,7936,1048,772,486,183,37,10462
E02000365,12561,1256,856,521,230,64,15488
E02000366,6833,1128,676,360,191,86,9274
E02000367,9647,1158,542,278,75,12,11712
E02000368,8245,1077,688,413,188,30,10641
E02000369,12028,1250,745,438,189,32,14682
E02000370,8083,1061,527,236,128,25,10060
E02000371,14427,1037,540,274,150,41,16469
E02006918,7709,870,472,254,112,33,9450
E02006921,6805,827,594,257,162,21,8666
E02000372,7261,1191,700,379,212,46,9789
E02000373,4893,828,483,259,131,34,6628
E02000374,4918,804,502,332,170,41,6767
E02000375,5262,862,547,285,154,36,7146
E02000376,5188,840,414,265,136,30,6873
E02000377,5915,1039,636,376,161,59,8186
E02000378,4741,752,504,306,136,25,6464
E02000379,5524,987,580,449,280,88,7908
E02000380,4093,733,448,303,138,22,5737
E02000381,5859,941,565,413,116,32,7926
E02000382,4228,811,426,295,113,20,5893
E02000383,6287,1012,666,567,251,86,8869
E02000384,5306,841,586,397,260,63,7453
E02000385,4674,545,345,225,63,18,5870
E02000386,5932,945,608,367,161,26,8039
E02000387,4484,634,411,303,134,14,5980
E02000388,6449,931,565,442,254,51,8692
E02000389,6029,1016,663,496,261,44,8509
E02000390,4858,640,387,291,117,23,6316
E02000391,5758,965,694,421,191,43,8072
E02000392,7254,1030,577,405,189,28,9483
E02000393,4488,648,358,259,150,25,5928
E02000394,6978,1052,626,426,181,21,9284
E02000395,4265,766,499,437,228,56,6251
E02000396,5073,923,530,398,134,22,7080
E02000397,6291,1135,598,332,172,33,8561
E02000398,5748,1056,623,258,148,32,7865
E02000400,5790,1026,636,412,194,40,8098
E02000401,4626,995,553,272,140,18,6604
E02000402,4678,973,514,276,139,32,6612
E02000403,6300,935,511,265,171,35,8217
E02000404,5733,884,550,366,187,18,7738
E02000405,4315,895,636,352,175,25,6398
E02000406,5301,926,499,298,135,17,7176
E02000407,5624,946,538,296,186,19,7609
E02000408,6273,1074,577,325,188,9,8446
E02000409,4314,777,602,281,163,19,6156
E02000410,4532,897,597,383,168,37,6614
E02000411,8515,1190,560,364,152,8,10789
E02000412,5892,842,527,299,188,23,7771
E02000413,5156,1072,622,429,229,67,7575
E02000414,5236,853,535,279,167,18,7088
E02000415,5436,765,528,326,213,18,7286
E02000416,5954,995,612,415,130,28,8134
E02000417,4258,843,673,455,279,61,6569
E02000418,3250,833,630,443,154,31,5341
E02000419,7086,904,454,328,178,24,8974
E02000420,6029,978,683,394,143,24,8251
E02000421,6244,997,515,278,189,35,8258
E02000422,6231,964,590,359,193,43,8380
E02000423,5851,739,444,245,151,27,7457
E02000424,4843,930,559,292,108,30,6762
E02000425,6470,660,415,191,132,23,7891
E02000426,3838,798,581,562,250,80,6109
E02000427,5367,729,435,226,123,23,6903
E02000428,6344,932,480,293,169,29,8247
E02000429,4608,962,633,466,187,37,6893
E02000430,5100,937,573,328,104,30,7072
E02000431,4422,708,417,352,168,36,6103
E02000432,4606,697,447,255,103,16,6124
E02006794,6370,1088,564,317,207,30,8576
E02000433,4557,954,864,887,693,275,8230
E02000434,6186,1108,1046,709,447,113,9609
E02000435,4852,902,838,686,392,103,7773
E02000436,2799,805,809,692,378,60,5543
E02000437,5241,1172,948,702,405,106,8574
E02000438,4790,1026,909,599,406,153,7883
E02000439,6257,1121,812,508,301,45,9044
E02000440,6215,1263,1058,669,358,74,9637
E02000441,4298,931,803,630,344,82,7088
E02000442,6461,1108,859,404,214,40,9086
E02000443,7406,1229,828,480,312,72,10327
E02000444,5894,1041,922,539,313,72,8781
E02000445,8066,1337,891,567,362,75,11298
E02000447,4648,994,763,590,229,58,7282
E02000448,4069,968,795,643,349,118,6942
E02000449,5650,1052,830,484,295,56,8367
E02000451,3961,901,766,559,290,67,6544
E02000452,6614,854,638,376,179,44,8705
E02000453,5759,1020,742,452,237,46,8256
E02000454,4269,970,767,620,316,71,7013
E02000455,7719,962,649,531,307,53,10221
E02000456,4921,917,711,420,247,66,7282
E02000457,4106,898,714,548,293,44,6603
E02000459,6594,1104,781,506,238,44,9267
E02000460,4956,844,556,305,168,29,6858
E02000461,5671,764,552,348,230,65,7630
E02000462,4584,927,604,432,215,45,6807
E02000463,5579,1182,824,463,206,42,8296
E02006795,5332,1014,867,478,291,34,8016
E02006882,8942,1842,1672,1096,518,128,14198
E02000464,5234,893,709,525,292,102,7755
E02000465,6858,1145,754,443,207,56,9463
E02000466,5899,1158,813,696,354,77,8997
E02000467,8444,1262,853,500,231,70,11360
E02000468,5322,1108,815,664,379,102,8390
E02000469,5016,886,659,481,246,71,7359
E02000470,5893,1166,938,819,422,135,9373
E02000471,3978,1132,1017,895,486,90,7598
E02000472,5819,1181,999,855,393,90,9337
E02000473,6611,1333,993,806,442,103,10288
E02000474,6200,1153,774,628,412,95,9262
E02000475,5955,1300,1057,883,525,170,9890
E02000476,7577,1007,733,550,335,92,10294
E02000477,5834,1287,1068,864,428,85,9566
E02000478,2919,874,781,744,427,65,5810
E02000479,6892,1147,781,472,247,81,9620
E02000480,9625,1506,910,604,415,101,13161
E02000481,4608,1126,856,786,583,161,8120
E02000482,3554,903,789,653,456,159,6514
E02000483,4645,1129,900,705,479,135,7993
E02000484,4848,1352,975,713,351,77,8316
E02000485,5413,1188,849,676,410,106,8642
E02000486,4200,1143,904,708,435,111,7501
E02000487,3980,1209,1059,917,479,115,7759
E02000488,4011,1143,942,798,382,49,7325
E02000489,5599,1139,885,649,370,69,8711
E02000490,4932,1077,738,693,441,104,7985
E02000491,6678,1265,821,675,336,79,9854
E02000492,3643,969,747,671,407,56,6493
E02000493,4755,873,554,340,244,50,6816
E02000494,4151,1098,1038,801,489,103,7680
E02000495,6697,1315,895,874,529,116,10426
E02000496,4596,1074,883,680,378,85,7696
E02000497,5735,1305,912,703,455,115,9225
E02000498,3545,879,780,619,271,57,6151
E02000499,4312,1151,856,717,483,85,7604
E02000500,4710,1197,987,764,443,136,8237
E02000501,5153,1240,830,685,377,85,8370
E02000502,6005,1009,698,560,402,102,8776
E02000503,6057,1292,838,526,287,59,9059
E02000504,4366,1092,782,718,375,116,7449
E02000506,4393,1170,1010,743,425,81,7822
E02000507,5691,992,775,473,281,46,8258
E02000508,9857,898,654,439,259,40,12147
E02000509,10150,818,631,368,179,40,12186
E02000510,6171,1145,815,640,380,72,9223
E02000511,6778,1412,784,580,381,60,9995
E02000512,6246,1065,648,509,245,45,8758
E02000513,7740,1173,583,371,192,38,10097
E02000514,7854,1319,822,480,280,62,10817
E02000515,9125,1357,887,536,261,43,12209
E02000516,6640,1102,740,368,180,9,9039
E02000517,7585,1115,815,427,179,41,10162
E02000518,6171,1124,709,508,221,48,8781
E02000519,6594,1158,706,511,280,56,9305
E02000520,10559,1632,987,568,310,58,14114
E02000521,10620,1383,760,440,208,75,13486
E02000522,7168,1049,740,456,261,82,9756
E02000523,9056,1269,827,497,215,35,11899
E02000524,5970,1011,666,391,210,73,8321
E02000525,7919,1195,761,426,215,25,10541
E02006796,6442,1108,737,593,358,43,9281
E02000526,5637,1208,797,530,253,59,8484
E02000528,8996,1462,1061,630,252,59,12460
E02000529,6383,1013,838,474,241,39,8988
E02000530,5393,880,587,313,179,29,7381
E02000531,7601,1204,906,556,307,57,10631
E02000532,5672,1403,889,667,289,44,8964
E02000533,5625,1109,808,577,238,39,8396
E02000534,5599,919,665,495,252,20,7950
E02000535,6225,1163,956,574,258,73,9249
E02000536,6541,1075,898,523,276,50,9363
E02000537,6403,1003,834,575,281,50,9146
E02000538,7127,1106,855,497,224,26,9835
E02000539,8153,1224,813,483,247,78,10998
E02000540,8200,1277,843,557,303,66,11246
E02000541,6930,1179,836,488,282,20,9735
E02000542,8857,1172,869,567,315,72,11852
E02000543,10816,1354,832,509,261,33,13805
E02000544,5274,1093,878,549,297,54,8145
E02000545,6127,1037,799,498,238,47,8746
E02000546,7122,1054,886,414,219,30,9725
E02000547,6775,1312,913,603,296,56,9955
E02000548,7102,1198,785,463,288,69,9905
E02000549,7759,1580,1019,691,364,73,11486
E02000550,8267,1255,711,439,174,37,10883
E02000551,6615,1072,739,446,200,31,9103
E02000552,6845,1029,618,351,167,32,9042
E02000553,4914,884,620,435,223,33,7109
E02006792,6300,1038,644,563,293,103,8941
E02000554,7484,1167,746,425,165,48,10035
E02000555,7291,1178,684,478,215,55,9901
E02000556,8773,1215,712,463,183,27,11373
E02000557,6423,1036,658,456,238,49,8860
E02000558,8027,1085,585,424,211,47,10379
E02000559,8409,1008,624,397,144,34,10616
E02000560,7451,803,455,323,156,37,9225
E02000561,6384,949,669,461,150,30,8643
E02000562,6650,986,606,407,206,66,8921
E02000563,6640,918,563,339,179,36,8675
E02000564,12221,1113,629,364,153,37,14517
E02000565,7099,974,502,284,177,27,9063
E02000566,7173,1056,678,455,160,29,9551
E02000567,8919,1258,736,440,218,45,11616
E02000568,10633,1051,674,428,249,46,13081
E02000569,8422,1160,806,547,318,62,11315
E02000570,7454,1136,722,442,205,23,9982
E02000571,7017,1053,610,419,213,26,9338
E02000572,7148,802,635,367,223,44,9219
E02000573,8102,1101,696,512,206,31,10648
E02000574,7648,1013,566,352,149,48,9776
E02000575,12957,1316,701,356,186,58,15574
E02000576,9777,1082,641,377,215,67,12159
E02000577,4358,927,645,419,242,45,6636
E02000578,3573,876,565,385,245,84,5728
E02000579,5265,1155,841,552,213,29,8055
E02000580,5072,1159,805,541,197,38,7812
E02000581,3826,873,673,590,273,44,6279
E02000582,4888,890,610,555,251,91,7285
E02000583,4394,1012,720,558,208,40,6932
E02000584,5356,1052,773,633,283,81,8178
E02000585,5159,1050,792,642,265,92,8000
E02000586,5401,1002,677,449,167,51,7747
E02000587,4958,946,755,587,248,88,7582
E02000588,4814,1145,841,653,295,50,7798
E02000589,6678,884,624,436,230,34,8886
E02000590,4058,1038,803,563,356,99,6917
E02000591,4818,836,612,445,136,39,6886
E02000592,4891,845,535,491,160,74,6996
E02000593,5874,989,607,524,184,32,8210
E02000594,4170,1204,1004,811,436,125,7750
E02000595,4813,1029,758,645,305,66,7616
E02000596,5260,965,730,484,229,49,7717
E02000597,4487,988,767,557,263,57,7119
E02000598,5305,1250,818,553,280,72,8278
E02000599,5359,1117,851,620,354,211,8512
E02000600,7239,968,652,536,254,67,9716
E02000601,10239,1564,843,551,223,53,13473
E02000602,9394,1048,737,425,237,47,11888
E02000603,6470,1115,677,459,221,48,8990
E02000604,6354,1275,840,527,254,96,9346
E02000605,5264,1186,842,605,336,111,8344
E02000606,8619,1052,787,554,263,75,11350
E02000607,6210,731,525,362,189,42,8059
E02000608,5949,634,443,309,182,42,7559
E02000609,4560,1158,888,663,331,75,7675
E02000610,5908,858,594,458,237,125,8180
E02000611,4426,1013,897,720,330,72,7458
E02000612,4843,1123,966,847,377,102,8258
E02000613,5827,1011,641,493,317,109,8398
E02000614,6439,1243,849,514,245,39,9329
E02000615,4939,1138,733,613,322,55,7800
E02000616,3869,801,640,441,216,34,6001
E02000617,5839,1289,815,603,276,71,8893
E02000619,6396,1232,795,456,191,48,9118
E02000620,8066,1234,687,367,213,55,10622
E02000621,9766,1243,772,441,165,45,12432
E02000622,6867,974,579,280,168,10,8878
E02000623,5767,1117,634,357,183,41,8099
E02000624,6993,975,506,246,162,58,8940
E02000625,6570,1005,482,261,133,31,8482
E02000626,6120,1262,547,247,99,47,8322
E02000627,7885,970,487,320,232,23,9917
E02000628,7249,1198,626,380,193,42,9688
E02000629,7261,868,501,269,101,37,9037
E02000630,6361,787,451,276,113,48,8036
E02000631,7085,1156,614,379,174,44,9452
E02000632,7815,644,379,202,151,24,9215
E02000633,7060,1013,592,267,126,29,9087
E02000634,5154,727,459,240,159,31,6770
E02000635,7282,1030,549,285,125,20,9291
E02000636,6463,788,451,308,116,19,8145
E02000637,7223,941,452,281,166,24,9087
E02000638,8585,1129,561,314,185,56,10830
E02000639,6128,1061,550,251,90,17,8097
E02000640,7831,896,533,369,200,47,9876
E02000641,6571,1047,603,255,162,48,8686
E02000642,7158,1191,692,436,205,62,9744
E02000643,7582,938,569,319,200,26,9634
E02000644,6900,1024,584,275,158,35,8976
E02000645,7517,1180,593,319,182,51,9842
E02000646,7966,1068,653,418,212,51,10368
E02000647,6528,1188,737,465,307,58,9283
E02000648,6235,999,532,346,184,52,8348
E02000649,10808,1398,742,390,207,41,13586
E02000650,5780,1036,547,267,123,45,7798
E02000651,6573,1117,753,416,245,52,9156
E02000652,5579,962,658,377,210,74,7860
E02006801,9081,924,712,380,191,44,11332
E02000653,9724,1101,506,286,143,8,11768
E02000654,6809,1047,539,246,149,20,8810
E02000655,7507,925,466,251,137,29,9315
E02000657,8075,893,556,313,119,33,9989
E02000658,6661,964,670,317,152,28,8792
E02000659,6166,1002,583,338,163,45,8297
E02000660,6953,834,444,235,128,43,8637
E02000661,4906,811,485,405,219,60,6886
E02000662,6749,1039,536,248,103,37,8712
E02000663,5499,914,538,331,119,36,7437
E02000664,11916,1275,783,406,241,60,14681
E02000665,6489,1039,591,389,198,48,8754
E02000666,5411,932,479,318,192,58,7390
E02000667,5145,855,491,275,150,18,6934
E02000668,5380,942,629,385,205,37,7578
E02000669,6291,1074,477,307,166,20,8335
E02000670,4858,904,474,220,163,27,6646
E02000671,6579,1010,627,351,166,33,8766
E02000672,7824,1273,603,297,239,41,10277
E02000673,6607,1001,622,373,157,32,8792
E02000674,5932,1261,738,376,252,38,8597
E02000675,6100,1168,810,502,237,65,8882
E02000676,6149,967,588,341,192,26,8263
E02000677,5116,1131,659,363,234,67,7570
E02000678,4936,985,467,281,159,51,6879
E02000679,6168,1052,581,381,156,62,8400
E02000680,5762,877,502,291,167,30,7629
E02000681,5966,1283,754,453,236,55,8747
E02000682,6421,1210,728,412,247,61,9079
E02000683,4549,841,560,348,203,43,6544
E02000685,6023,1124,639,430,224,60,8500
E02000686,5513,1014,504,318,121,25,7495
E02000687,5962,1047,678,392,281,39,8399
E02006783,5563,1030,523,294,211,43,7664
E02006784,5440,1082,739,478,272,73,8084
E02006798,6445,935,584,265,66,19,8314
E02000689,6339,931,630,342,143,30,8415
E02000690,2912,891,705,603,343,116,5570
E02000691,5497,868,522,333,169,58,7447
E02000692,5218,939,728,588,326,119,7918
E02000693,7529,851,552,355,198,46,9531
E02000694,7099,863,587,385,156,20,9110
E02000695,5910,1057,708,482,285,40,8482
E02000696,6080,980,535,270,147,11,8023
E02000697,7137,889,486,333,156,22,9023
E02000698,5096,1100,767,658,307,88,8016
E02000699,6124,899,567,416,229,49,8284
E02000700,6175,1013,694,366,130,18,8396
E02000701,5961,1116,660,423,229,42,8431
E02000702,6361,1082,718,352,183,40,8736
E02000703,5116,984,807,624,365,51,7947
E02000704,6038,909,615,423,259,82,8326
E02000705,5734,1187,808,480,266,50,8525
E02000706,6996,1127,684,355,172,39,9373
E02000707,5000,1219,692,351,165,29,7456
E02000708,5533,1125,799,557,286,47,8347
E02000709,4648,1115,840,640,325,78,7646
E02000710,5678,1073,767,567,407,83,8575
E02000711,6417,1139,628,400,226,47,8857
E02000712,5903,1280,716,492,325,54,8770
E02000713,4539,1119,742,579,307,58,7344
E02000714,6238,926,501,246,141,28,8080
E02000715,5879,792,514,273,181,30,7669
E02000716,5950,757,554,268,157,43,7729
E02000717,6642,812,542,267,132,27,8422
E02000718,5875,751,442,243,113,15,7439
E02000719,6627,902,538,376,167,19,8629
E02000720,5780,845,627,341,152,31,7776
E02000721,7669,923,562,320,207,10,9691
E02000722,6715,812,520,249,145,29,8470
E02000723,8487,1237,876,423,218,47,11288
E02000724,7776,921,692,357,202,36,9984
E02000725,8186,947,583,289,115,33,10153
E02000726,24148,1282,653,281,123,26,26513
E02000727,6780,896,560,264,130,32,8662
E02000728,6290,862,587,311,126,20,8196
E02000729,5568,773,556,263,132,26,7318
E02000730,6870,828,726,405,217,36,9082
E02000731,8638,1065,695,386,172,26,10982
E02000732,6052,888,550,282,156,27,7955
E02000733,7596,1187,739,401,190,24,10137
E02000734,5765,947,509,258,161,15,7655
E02000735,6528,898,559,365,216,111,8677
E02000736,6979,1071,544,268,153,41,9056
E02000737,7675,1186,636,428,176,38,10139
E02000738,7168,978,574,293,181,24,9218
E02000739,5829,808,547,280,113,16,7593
E02000740,5463,810,514,231,106,11,7135
E02000741,6718,982,645,285,122,31,8783
E02000742,6845,938,528,253,171,50,8785
E02000743,7795,1108,708,352,179,38,10180
E02000744,7418,1050,516,301,202,20,9507
E02000745,6130,1082,625,260,87,47,8231
E02000746,6688,869,554,195,132,11,8449
E02000747,11673,1122,659,420,163,55,14092
E02000748,5008,717,469,201,73,7,6475
E02000749,6463,1060,577,329,115,26,8570
E02000750,14120,1281,589,276,126,22,16414
E02000751,5984,1522,1240,1095,601,174,10616
E02000752,5433,1054,641,453,197,54,7832
E02000753,4509,863,530,347,256,84,6589
E02000754,4466,908,628,423,185,35,6645
E02000755,3689,758,507,421,197,21,5593
E02000756,9449,1801,1215,880,427,88,13860
E02000757,8879,1521,1075,730,436,97,12738
E02000758,4035,905,630,432,265,58,6325
E02000759,9463,1714,1100,651,326,63,13317
E02000760,4952,852,602,462,266,89,7223
E02000762,4329,843,700,442,262,80,6656
E02000763,5333,945,665,405,213,68,7629
E02000764,8043,1548,1181,912,543,194,12421
E02000765,4927,789,619,360,260,69,7024
E02000767,6066,891,683,478,246,61,8425
E02000768,3632,855,605,451,222,58,5823
E02000769,11772,1835,1093,583,424,108,15815
E02000770,5859,945,653,388,227,47,8119
E02000772,6987,911,639,283,176,58,9054
E02000773,7673,1089,718,396,181,43,10100
E02000774,5594,754,631,364,183,33,7559
E02000776,5193,754,590,295,132,25,6989
E02000777,3790,845,716,424,196,53,6024
E02000779,7106,850,593,306,164,34,9053
E02000780,14240,1547,1032,618,296,73,17806
E02000781,10935,1655,1247,806,382,115,15140
E02000782,8587,938,620,341,191,67,10744
E02000783,6170,793,430,262,134,24,7813
E02006800,10864,1631,1144,567,220,62,14488
E02006924,9651,1485,1250,805,445,131,13767
E02006925,9203,1842,1442,960,504,84,14035
E02000784,6098,1583,1094,858,377,111,10121
E02000785,6294,1470,981,826,391,108,10070
E02000786,7833,1529,1049,792,314,88,11605
E02000787,8582,1578,969,730,318,74,12251
E02000788,6112,1183,853,602,272,82,9104
E02000789,4302,942,576,500,225,79,6624
E02000790,4726,910,501,355,153,28,6673
E02000791,4933,950,634,514,234,68,7333
E02000792,4653,1095,677,560,266,99,7350
E02000793,5453,1047,850,619,270,100,8339
E02000794,4829,927,589,426,229,56,7056
E02000795,4415,1027,692,652,294,105,7185
E02000796,7044,1451,1032,779,402,83,10791
E02000797,5754,944,647,429,192,31,7997
E02000798,7491,1577,944,663,329,84,11088
E02000799,3883,995,665,460,183,43,6229
E02000800,3449,844,552,392,194,58,5489
E02000801,4804,1036,663,495,196,35,7229
E02000802,4252,1062,705,555,261,98,6933
E02000803,5776,1349,1103,742,399,101,9470
E02000804,4618,1074,736,557,283,67,7335
E02000805,7374,1657,1110,788,381,121,11431
E02000806,6089,1516,1285,868,432,126,10316
E02000807,7507,901,650,324,109,18,9509
E02000808,9267,1093,630,285,138,41,11454
E02000809,11752,1442,751,272,81,16,14314
E02000810,10804,1382,728,380,163,54,13511
E02000812,8340,1188,643,382,190,73,10816
E02000813,8540,1135,641,350,162,37,10865
E02000814,8248,957,657,334,128,32,10356
E02000815,6253,493,247,104,94,58,7249
E02000816,8200,1120,676,376,184,37,10593
E02000817,5226,872,577,322,229,61,7287
E02000818,6369,958,611,383,145,44,8510
E02000819,6480,1267,598,302,151,30,8828
E02000820,8199,1137,588,369,174,48,10515
E02000821,5954,992,516,295,131,50,7938
E02000822,5456,917,479,221,123,23,7219
E02000823,6450,1211,693,394,181,18,8947
E02000824,7157,1289,740,381,191,39,9797
E02000825,7148,1241,610,353,132,35,9519
E02000826,6886,1159,679,356,185,31,9296
E02000827,8184,1493,815,415,163,55,11125
E02000828,6333,1163,640,295,153,24,8608
E02000829,8625,1466,791,436,213,50,11581
E02000830,6842,1179,658,363,188,41,9271
E02000831,7566,1115,664,406,173,39,9963
E02000832,7731,1351,859,486,273,55,10755
E02000833,6768,979,481,257,180,33,8698
E02000834,7510,1012,661,428,198,59,9868
E02000835,5748,992,587,280,166,30,7803
E02000836,6288,1106,604,357,170,34,8559
E02000837,6381,1295,850,526,276,90,9418
E02000838,7235,1145,758,421,192,65,9816
E02000839,5898,1135,701,499,210,58,8501
E02006802,6379,1036,527,247,126,26,8341
E02000840,6340,1142,600,369,205,36,8692
E02000841,6569,1267,732,383,256,43,9250
E02000842,4989,1204,835,605,277,52,7962
E02000843,6366,1051,620,389,193,29,8648
E02000844,5948,1139,660,456,229,38,8470
E02000845,7207,1212,759,514,258,44,9994
E02000846,4813,1087,730,580,311,93,7614
E02000847,5716,1275,1012,918,478,125,9524
E02000848,5238,1221,702,555,280,72,8068
E02000849,5252,1149,748,590,266,51,8056
E02000850,6997,1645,1065,730,347,86,10870
E02000851,7604,1131,656,539,343,72,10345
E02000852,5491,1064,689,478,263,61,8046
E02000853,5581,1067,646,493,265,50,8102
E02000854,4964,1073,735,546,264,56,7638
E02000855,4731,1241,894,727,392,103,8088
E02000856,6160,1250,837,688,299,59,9293
E02000857,6124,921,674,507,397,158,8781
E02000858,5973,1079,672,448,181,38,8391
E02000859,5332,1126,867,737,481,156,8699
E02000860,6120,948,678,476,279,77,8578
E02000861,4376,1247,977,847,332,69,7848
E02000863,4058,1054,823,577,290,50,6852
E02006836,4858,1209,938,903,489,143,8540
E02000864,8367,1090,716,359,224,38,10794
E02000865,6707,737,490,283,125,42,8384
E02000866,8353,1116,832,435,180,12,10928
E02000867,10837,935,598,284,115,31,12800
E02000868,6225,563,356,178,99,47,7468
E02000869,5067,729,455,277,112,26,6666
E02000870,5480,652,427,226,115,40,6940
E02000871,9641,949,547,280,172,36,11625
E02000872,7635,727,400,175,131,29,9097
E02000873,9637,641,385,245,157,38,11103
E02000874,6714,680,431,210,91,10,8136
E02000875,11698,1069,647,290,107,32,13843
E02000876,6861,585,418,139,72,18,8093
E02000877,11260,971,570,307,183,33,13324
E02000878,10016,855,591,328,160,44,11994
E02000879,7288,758,570,376,300,50,9342
E02000880,5585,503,328,163,125,19,6723
E02000881,7763,874,500,232,132,14,9515
E02000882,8687,967,565,283,158,42,10702
E02000883,7056,884,524,309,162,36,8971
E02000884,12200,752,453,244,166,18,13833
E02000885,5973,706,482,337,189,24,7711
E02000886,7695,848,535,245,124,28,9475
E02000887,9521,901,564,264,135,36,11421
E02000888,8607,881,491,217,141,10,10347
E02000889,7009,765,545,241,105,15,8680
E02000890,4962,855,596,292,103,21,6829
E02000891,18069,1233,603,295,163,10,20373
E02000893,6354,807,539,291,111,30,8132
E02000894,9965,1017,607,302,96,24,12011
E02006853,9553,831,393,218,96,15,11106
E02006854,7095,757,356,139,25,7,8379
E02000895,4733,1127,844,831,509,136,8180
E02000896,5331,1326,1006,812,446,123,9044
E02000897,5432,1186,785,620,406,129,8558
E02000898,4827,1138,886,592,363,93,7899
E02000899,5405,1273,836,590,425,127,8656
E02000900,5899,1224,763,527,295,63,8771
E02000901,6708,1469,993,683,285,66,10204
E02000902,7124,1160,745,482,238,52,9801
E02000903,7424,1183,694,407,169,33,9910
E02000904,6542,1113,660,354,154,36,8859
E02000905,7967,1175,675,348,148,56,10369
E02000906,7395,1064,533,338,163,47,9540
E02000907,8454,1147,627,401,242,74,10945
E02000908,10263,1200,722,386,185,41,12797
E02000909,6627,1083,681,379,214,43,9027
E02000910,8256,1143,723,383,230,50,10785
E02000911,9144,1351,735,421,194,38,11883
E02000912,6948,981,659,443,260,98,9389
E02000913,6742,979,756,438,228,27,9170
E02000914,8648,1182,738,368,246,57,11239
E02000915,7011,994,736,339,161,41,9282
E02000916,7617,1150,603,364,146,32,9912
E02000917,8408,936,537,296,131,40,10348
E02000918,7579,969,691,374,164,32,9809
E02000919,7868,893,624,373,217,32,10007
E02000920,8004,1110,657,364,165,29,10329
E02000921,8615,1282,786,413,163,23,11282
E02000922,8435,1252,699,391,178,33,10988
E02000923,5615,1005,672,537,294,74,8197
E02000924,11848,1420,841,409,216,36,14770
E02000925,5985,993,560,326,172,32,8068
E02000926,8747,1119,718,523,218,24,11349
E02000927,5524,730,502,369,154,40,7319
E02000928,6115,994,718,521,192,48,8588
E02000929,5698,770,515,313,165,47,7508
E02000930,9294,771,448,275,152,35,10975
E02000931,8005,851,388,278,136,35,9693
E02000932,9407,1091,710,435,149,35,11827
E02000933,6244,1043,812,558,290,59,9006
E02000934,8187,829,485,333,143,42,10019
E02000935,5469,695,417,317,159,65,7122
E02000936,6957,852,601,539,253,66,9268
E02000937,6645,938,525,265,137,38,8548
E02000938,8248,1153,793,618,381,99,11292
E02000939,6179,930,591,385,197,92,8374
E02000940,6913,707,485,302,152,24,8583
E02000941,8090,1061,638,423,204,29,10445
E02000942,6913,1181,744,545,206,30,9619
E02000943,7172,726,512,313,161,17,8901
E02000944,5552,811,450,292,167,45,7317
E02000945,6418,806,571,330,163,47,8335
E02000946,6754,862,512,281,132,33,8574
E02000947,7098,907,511,376,169,26,9087
E02000948,8049,778,450,367,218,29,9891
E02000949,7388,1143,667,457,207,40,9902
E02000950,5503,869,592,400,166,42,7572
E02000951,4846,670,415,243,183,39,6396
E02000952,4540,691,423,264,146,26,6090
E02000953,6516,631,338,207,127,21,7840
E02000954,4721,545,423,323,163,25,6200
E02000955,4883,651,436,320,185,30,6505
E02000956,6767,678,403,261,159,25,8293
E02000957,8851,1030,627,391,233,33,11165
E02000958,6054,1113,719,454,270,55,8665
E02000959,6379,1016,463,317,158,41,8374
E02000960,5989,919,722,570,393,123,8716
E02000961,8252,1440,809,561,317,95,11474
E02000962,7307,1149,931,761,462,103,10713
E02000963,7853,1419,914,571,311,42,11110
E02000964,10017,1617,1091,584,315,36,13660
E02000965,7393,927,622,300,137,44,9423
E02000966,8069,1415,917,593,295,74,11363
E02000967,7995,961,739,477,265,69,10506
E02000968,11226,1852,1424,826,563,109,16000
E02000969,7958,1353,764,449,308,102,10934
E02000970,8035,1309,993,644,306,54,11341
E02000971,7353,999,771,533,273,63,9992
E02000972,8538,1267,743,480,240,39,11307
E02000973,8525,1292,873,637,240,55,11622
E02000974,7669,1053,871,582,277,87,10539
E02000975,8364,1049,580,471,171,44,10679
E02000976,8885,1100,708,572,226,38,11529
E02000977,4521,1275,864,555,250,63,7528
E02000978,8075,1485,1072,648,368,98,11746
E02000979,7012,1549,1057,644,278,87,10627
E02000980,7294,1459,1021,670,360,94,10898
E02000981,7431,1282,875,553,233,52,10426
E02000982,6288,1181,830,583,300,64,9246
E02000983,6761,1214,853,629,376,105,9938
