MSOA_code,under_70,over70-74,over75-79,over80,total
E02002796,1083,424,347,450,2304
E02002797,1141,516,463,854,2974
E02002798,1740,503,307,369,2919
E02002799,981,203,156,233,1573
E02002800,1091,372,293,516,2272
E02002801,1241,389,303,463,2396
E02002802,1253,237,179,249,1918
E02002803,1032,204,143,180,1559
E02002804,1588,350,234,408,2580
E02002805,972,435,384,495,2286
E02002806,821,145,80,116,1162
E02002807,1399,494,338,439,2670
E02002808,1524,199,141,213,2077
E02002809,1138,346,311,459,2254
E02002810,1771,544,391,621,3327
E02002811,932,143,103,182,1360
E02002812,1551,331,252,443,2577
E02002813,980,161,118,264,1523
E02002814,1515,537,365,630,3047
E02002815,705,118,98,190,1111
E02002816,1720,390,257,306,2673
E02002817,1130,347,252,391,2120
E02002818,959,208,154,298,1619
E02002819,1144,330,237,328,2039
E02002820,1442,323,226,265,2256
E02002821,1430,263,176,294,2163
E02002822,1090,284,225,410,2009
E02002823,1266,410,374,438,2488
E02002824,1418,390,269,271,2348
E02002825,1363,468,322,504,2657
E02002826,1125,291,187,281,1884
E02002827,857,202,141,135,1335
E02002828,1366,387,257,349,2359
E02002829,1288,317,170,326,2101
E02002830,1462,321,162,178,2123
E02002831,1038,291,187,308,1824
E02002832,1268,396,245,397,2306
E02002833,1081,288,169,225,1763
E02002834,1393,427,293,410,2523
E02002835,2063,361,227,322,2973
E02002836,1296,384,226,358,2264
E02002837,762,157,115,144,1178
E02002838,997,275,180,214,1666
E02002839,1214,303,232,324,2073
E02002842,671,131,65,86,953
E02002843,1048,298,174,210,1730
E02002844,958,233,155,210,1556
E02002845,1261,308,188,299,2056
E02002846,1205,341,234,337,2117
E02002847,1111,246,174,257,1788
E02002848,1065,248,146,193,1652
E02002849,1194,200,145,250,1789
E02002851,1391,395,299,536,2621
E02002852,1072,197,109,135,1513
E02002853,1713,331,231,337,2612
E02002854,1169,194,169,280,1812
E02002855,993,189,132,170,1484
E02002856,1780,333,254,429,2796
E02002857,927,161,110,134,1332
E02002858,1325,368,260,440,2393
E02002860,1355,408,272,437,2472
E02002861,1060,207,127,192,1586
E02002862,1292,300,181,329,2102
E02006815,1516,364,246,466,2592
E02006817,1234,229,186,302,1951
E02006819,1058,242,147,204,1651
E02006850,1142,69,59,74,1344
E02006851,673,48,19,26,766
E02002863,700,486,360,381,1927
E02002864,835,493,424,558,2310
E02002865,760,563,452,706,2481
E02002866,711,604,371,555,2241
E02002867,814,576,454,630,2474
E02002868,929,384,311,349,1973
E02002869,964,283,175,263,1685
E02002871,1155,345,268,407,2175
E02002872,1104,368,260,223,1955
E02002873,1201,213,135,268,1817
E02002874,1119,262,201,300,1882
E02002875,1006,217,172,225,1620
E02002876,911,267,232,279,1689
E02002877,1208,340,228,309,2085
E02002878,917,146,110,109,1282
E02002879,1134,212,167,185,1698
E02002880,925,188,111,135,1359
E02002881,889,197,145,221,1452
E02002882,1061,270,143,281,1755
E02002883,906,228,148,177,1459
E02002884,536,93,70,126,825
E02002885,475,93,68,74,710
E02002886,1030,288,252,365,1935
E02002887,921,329,267,371,1888
E02002888,716,181,114,173,1184
E02002889,469,70,33,55,627
E02002890,588,170,125,144,1027
E02002891,917,311,214,324,1766
E02002892,825,235,156,249,1465
E02002893,1001,117,78,113,1309
E02002894,1169,324,218,387,2098
E02002895,893,162,104,117,1276
E02002896,743,197,122,146,1208
E02002897,1186,436,326,598,2546
E02002898,1249,102,73,129,1553
E02002899,1187,167,137,192,1683
E02002901,1086,270,211,403,1970
E02002902,1095,274,194,382,1945
E02002903,846,273,189,443,1751
E02002904,875,209,140,294,1518
E02006834,976,289,216,403,1884
E02006904,636,91,57,59,843
E02006905,776,175,124,173,1248
E02004029,1130,357,246,342,2075
E02004030,896,509,368,422,2195
E02004031,973,350,237,259,1819
E02004032,1263,649,465,494,2871
E02004033,1217,496,359,456,2528
E02004034,951,570,457,435,2413
E02004035,921,488,410,444,2263
E02004036,1317,662,466,500,2945
E02004037,1109,476,338,470,2393
E02004038,1028,509,343,469,2349
E02004039,1121,469,344,390,2324
E02004040,1263,494,340,369,2466
E02004041,975,390,302,311,1978
E02004043,1107,475,354,404,2340
E02004044,1267,552,426,667,2912
E02006827,977,393,276,368,2014
E02004045,1601,615,455,486,3157
E02004046,1026,412,304,366,2108
E02004047,794,290,248,258,1590
E02004048,911,343,234,303,1791
E02004049,1172,525,399,504,2600
E02004050,971,272,295,352,1890
E02004051,1448,470,395,384,2697
E02004052,1433,436,366,389,2624
E02004053,1223,353,289,300,2165
E02004054,1524,458,365,451,2798
E02004055,1124,384,313,410,2231
E02004056,1309,334,248,315,2206
E02004057,1410,307,207,220,2144
E02004058,1174,377,315,393,2259
E02004059,1416,454,375,477,2722
E02004060,1355,481,347,422,2605
E02004061,1223,367,305,452,2347
E02004062,1365,537,324,413,2639
E02004063,1342,511,422,576,2851
E02004064,1364,309,188,320,2181
E02004065,1590,667,520,658,3435
E02004066,2033,663,476,649,3821
E02004067,1004,318,234,300,1856
E02004068,866,545,402,549,2362
E02004069,779,572,452,556,2359
E02004070,655,502,391,575,2123
E02004071,517,388,288,370,1563
E02004072,1085,731,569,737,3122
E02004073,1108,662,491,577,2838
E02004074,1052,445,314,380,2191
E02004075,1196,575,446,451,2668
E02004076,1191,399,316,482,2388
E02004077,1345,516,405,482,2748
E02004078,837,398,249,326,1810
E02004080,1220,424,312,483,2439
E02004081,969,412,298,383,2062
E02004082,996,454,334,483,2267
E02004083,982,355,318,305,1960
E02004084,768,294,267,377,1706
E02004085,1202,487,385,592,2666
E02004086,1175,433,394,490,2492
E02004087,1051,353,240,363,2007
E02004088,1107,490,355,430,2382
E02004089,701,231,177,236,1345
E02004090,1025,406,295,409,2135
E02004091,1223,517,388,452,2580
E02004092,1179,487,434,499,2599
E02006828,955,378,223,235,1791
E02004093,931,325,202,226,1684
E02004094,915,337,237,270,1759
E02004095,1426,540,353,435,2754
E02004096,1522,639,500,501,3162
E02004097,996,493,351,322,2162
E02004098,1089,476,312,352,2229
E02004100,1146,511,392,461,2510
E02004102,908,478,365,616,2367
E02004103,867,284,232,307,1690
E02004104,939,430,326,387,2082
E02006872,1725,857,649,782,4013
E02004105,1628,596,347,395,2966
E02004106,1043,591,468,587,2689
E02004108,1170,408,390,549,2517
E02004109,1124,603,502,601,2830
E02004110,1319,499,472,521,2811
E02004111,1047,376,292,356,2071
E02004112,1065,587,473,583,2708
E02004113,1488,460,364,435,2747
E02004114,1201,585,512,607,2905
E02004115,1488,521,416,448,2873
E02004116,1220,448,378,429,2475
E02004117,1142,510,389,451,2492
E02006804,1018,399,313,450,2180
E02004118,1488,369,254,345,2456
E02004119,2144,471,373,457,3445
E02004120,1891,511,323,338,3063
E02004121,1562,445,376,475,2858
E02004122,1160,431,326,347,2264
E02004123,1066,407,304,457,2234
E02004124,1153,421,315,385,2274
E02004125,1335,504,358,376,2573
E02004126,1165,464,301,376,2306
E02004128,1623,720,543,580,3466
E02006919,1379,365,228,245,2217
E02006920,1101,310,195,208,1814
E02005334,965,223,208,289,1685
E02005335,1180,437,366,653,2636
E02005336,938,210,158,237,1543
E02005337,1395,455,357,550,2757
E02005338,1559,545,357,545,3006
E02005339,1290,500,342,382,2514
E02005340,1408,493,471,565,2937
E02005341,1051,360,226,308,1945
E02005342,1089,475,366,393,2323
E02005343,1342,537,386,433,2698
E02005344,1248,562,436,489,2735
E02006820,1853,710,462,731,3756
E02005345,813,385,256,249,1703
E02005346,1127,308,209,338,1982
E02005347,726,245,165,299,1435
E02005348,658,445,330,341,1774
E02005349,927,447,360,391,2125
E02005350,883,407,274,368,1932
E02005351,622,236,209,259,1326
E02005352,1012,383,277,337,2009
E02005353,1086,388,288,364,2126
E02005354,1212,515,434,703,2864
E02005355,1241,457,335,381,2414
E02005356,987,480,328,457,2252
E02005357,1302,350,240,309,2201
E02005358,1677,517,434,579,3207
E02005359,1196,484,340,416,2436
E02005360,1096,471,329,451,2347
E02005361,1094,330,241,324,1989
E02005362,1052,416,299,378,2145
E02005363,1331,471,349,630,2781
E02005364,800,219,196,285,1500
E02005365,1553,510,414,528,3005
E02005366,1059,453,355,410,2277
E02005368,888,420,315,378,2001
E02005369,2110,707,547,722,4086
E02005370,1482,516,298,360,2656
E02005371,1691,650,473,542,3356
E02005372,1346,629,470,534,2979
E02005373,1786,745,559,615,3705
E02005374,924,320,282,496,2022
E02005375,1350,516,413,633,2912
E02005376,1293,613,521,606,3033
E02006816,1410,451,350,568,2779
E02005377,1413,602,439,542,2996
E02005378,906,285,235,314,1740
E02005379,958,416,285,365,2024
E02005380,1154,668,473,546,2841
E02005381,1293,626,505,541,2965
E02005382,1815,597,432,548,3392
E02005383,1450,550,382,428,2810
E02005384,950,411,353,436,2150
E02005385,1010,480,310,412,2212
E02005386,1165,400,306,439,2310
E02005387,1320,480,354,299,2453
E02005388,789,316,206,286,1597
E02005389,804,375,319,536,2034
E02005390,1475,703,475,562,3215
E02005391,1394,696,499,594,3183
E02005392,1198,563,438,575,2774
E02005393,1102,497,321,411,2331
E02005394,1177,526,367,467,2537
E02005395,1172,509,400,520,2601
E02005396,934,513,363,445,2255
E02005397,1285,535,404,429,2653
E02005398,853,389,275,341,1858
E02005399,907,463,280,317,1967
E02005400,847,449,319,346,1961
E02005401,918,403,297,296,1914
E02005402,875,480,333,451,2139
E02005403,924,393,356,408,2081
E02005404,1197,467,307,373,2344
E02005405,1021,467,307,394,2189
E02005406,965,252,204,294,1715
E02005407,1352,437,318,355,2462
E02005408,1109,421,345,329,2204
E02005409,1387,623,449,496,2955
E02005412,1328,452,374,757,2911
E02005414,1122,386,282,587,2377
E02005415,1069,329,309,461,2168
E02005416,1399,686,503,577,3165
E02006818,1174,397,366,632,2569
E02006911,2956,664,466,780,4866
E02005417,1261,521,416,510,2708
E02005418,1018,347,232,380,1977
E02005419,1050,230,195,284,1759
E02005420,1270,405,302,459,2436
E02005422,918,467,349,400,2134
E02005423,1499,600,453,639,3191
E02006864,1512,530,394,580,3016
E02006865,1285,492,400,550,2727
E02005424,1179,862,648,681,3370
E02005425,748,554,420,436,2158
E02005426,1163,600,506,687,2956
E02005427,853,470,364,484,2171
E02005428,1120,739,617,644,3120
E02005429,842,805,645,688,2980
E02005430,867,584,465,557,2473
E02005431,1386,756,565,672,3379
E02005432,1073,663,495,529,2760
E02005433,1078,803,540,562,2983
E02005434,918,506,462,573,2459
E02005435,1043,684,481,482,2690
E02005436,1211,626,512,632,2981
E02005437,731,316,227,307,1581
E02005438,844,488,380,500,2212
E02005439,1446,832,698,953,3929
E02005440,769,420,277,394,1860
E02005441,1498,675,508,589,3270
E02005442,943,220,166,226,1555
E02005443,1252,354,271,386,2263
E02005444,1743,529,404,675,3351
E02005445,1480,303,179,223,2185
E02005446,772,179,110,136,1197
E02005447,674,120,106,241,1141
E02005448,963,276,196,243,1678
E02005449,1027,298,225,320,1870
E02005450,1364,569,416,541,2890
E02005451,1129,260,189,339,1917
E02005452,1775,644,440,630,3489
E02005453,1754,785,604,818,3961
E02005455,2227,804,620,676,4327
E02005456,1568,535,444,633,3180
E02005457,1340,582,458,570,2950
E02005458,1023,564,409,540,2536
E02005459,1396,595,430,502,2923
E02005460,851,270,227,252,1600
E02005461,1079,543,438,553,2613
E02005462,1453,515,376,535,2879
E02005463,1505,481,348,428,2762
E02005464,1497,684,522,646,3349
E02006866,1298,448,348,508,2602
E02006867,1315,514,442,633,2904
E02005465,1281,656,437,595,2969
E02005466,924,543,343,470,2280
E02005467,1024,429,365,660,2478
E02005468,1078,586,375,512,2551
E02005469,1039,510,361,421,2331
E02005470,1259,514,418,717,2908
E02005471,915,479,371,517,2282
E02005472,1191,720,589,789,3289
E02005473,1027,510,432,589,2558
E02005474,921,535,370,462,2288
E02005475,949,419,304,353,2025
E02005476,1236,471,408,461,2576
E02005477,1370,835,598,694,3497
E02005478,1433,587,487,665,3172
E02005479,1423,571,420,539,2953
E02005480,786,284,201,191,1462
E02005481,1435,452,345,549,2781
E02005482,1495,704,447,479,3125
E02005483,1372,523,433,518,2846
E02005484,1013,473,380,386,2252
E02005485,1092,470,375,490,2427
E02005486,1265,495,396,653,2809
E02005487,1310,722,541,605,3178
E02005488,980,460,345,443,2228
E02005489,976,483,315,337,2111
E02005490,880,539,389,538,2346
E02005491,1012,649,545,798,3004
E02005492,1508,713,519,582,3322
E02005493,1721,705,496,594,3516
E02005494,1207,705,534,727,3173
E02005495,1166,457,385,412,2420
E02005496,1091,465,333,308,2197
E02005497,817,346,252,309,1724
E02005498,1247,664,530,582,3023
E02005499,1472,518,400,498,2888
E02005500,1199,486,415,430,2530
E02005501,1420,612,478,636,3146
E02005502,1679,726,551,683,3639
E02005612,778,346,277,327,1728
E02005613,877,364,277,333,1851
E02005614,1163,413,294,341,2211
E02005615,964,448,347,469,2228
E02005616,487,191,143,197,1018
E02005617,1031,357,270,327,1985
E02006862,844,317,211,229,1601
E02006863,1137,217,129,136,1619
E02005619,932,398,282,390,2002
E02005620,1273,476,349,376,2474
E02005621,1089,597,405,511,2602
E02005622,1254,581,430,481,2746
E02005623,1531,607,422,623,3183
E02005624,1000,455,319,316,2090
E02005625,858,506,407,566,2337
E02005626,607,302,196,164,1269
E02005627,1093,524,360,401,2378
E02005628,1265,506,362,391,2524
E02005629,685,450,320,370,1825
E02005630,982,666,528,700,2876
E02005631,1098,604,409,491,2602
E02005632,817,443,323,400,1983
E02005633,940,609,398,451,2398
E02005634,1299,450,303,361,2413
E02005635,1467,540,381,424,2812
E02005636,1720,644,460,535,3359
E02005637,1229,366,266,482,2343
E02005638,1532,655,458,494,3139
E02005639,811,411,288,369,1879
E02005640,1583,673,469,516,3241
E02005641,1144,521,336,318,2319
E02005642,1159,442,339,419,2359
E02005643,884,277,198,228,1587
E02005644,901,184,124,136,1345
E02005645,1598,497,424,740,3259
E02005646,893,481,379,395,2148
E02005647,934,334,278,386,1932
E02005648,1293,487,426,450,2656
E02005649,2507,750,547,654,4458
E02005650,884,372,250,229,1735
E02005651,932,448,364,435,2179
E02005652,938,465,347,495,2245
E02005653,821,261,157,129,1368
E02005654,896,284,173,177,1530
E02005655,911,431,292,458,2092
E02005656,684,207,143,105,1139
E02005657,923,374,297,394,1988
E02005658,735,159,115,147,1156
E02005659,789,307,235,355,1686
E02005660,915,382,200,182,1679
E02005661,805,177,107,187,1276
E02005662,846,271,245,355,1717
E02005663,881,355,211,232,1679
E02005664,735,200,163,297,1395
E02005665,1079,397,246,235,1957
E02005666,816,222,126,177,1341
E02005667,892,327,306,394,1919
E02005668,925,366,321,527,2139
E02005669,942,366,296,403,2007
E02005670,695,144,68,111,1018
E02005671,887,159,125,189,1360
E02005672,676,102,72,81,931
E02005673,767,287,189,291,1534
E02005674,1062,224,163,405,1854
E02005675,701,191,109,142,1143
E02005676,735,220,140,194,1289
E02005677,981,318,226,277,1802
E02005678,1599,486,301,457,2843
E02005679,1092,350,211,264,1917
E02005680,1022,275,191,290,1778
E02005681,1251,588,488,520,2847
E02005682,978,480,358,361,2177
E02005683,1756,712,525,621,3614
E02005684,1069,589,400,449,2507
E02005685,875,515,310,406,2106
E02005686,958,535,391,501,2385
E02005687,582,405,268,306,1561
E02005688,984,552,362,435,2333
E02005689,817,421,290,398,1926
E02005690,447,263,226,297,1233
E02005691,600,434,312,383,1729
E02005692,979,482,365,348,2174
E02005693,927,350,248,344,1869
E02005694,1116,492,331,306,2245
E02005695,900,226,177,249,1552
E02005696,635,216,205,251,1307
E02005697,776,277,215,402,1670
E02005698,693,322,247,326,1588
E02005699,972,274,191,233,1670
E02005700,1507,740,511,559,3317
E02005701,1372,785,524,560,3241
E02005819,1148,358,319,317,2142
E02005820,1158,361,350,336,2205
E02005821,1008,314,252,246,1820
E02005822,1686,322,229,358,2595
E02005823,1166,317,277,466,2226
E02005824,1783,515,416,443,3157
E02005825,1284,406,326,369,2385
E02005826,949,198,166,225,1538
E02005827,1682,379,301,438,2800
E02005828,1318,456,399,345,2518
E02005829,1073,430,311,373,2187
E02005830,1002,409,328,321,2060
E02005831,1661,453,372,465,2951
E02005832,1206,327,291,395,2219
E02005833,1353,484,375,381,2593
E02005834,1298,346,299,341,2284
E02005835,1459,543,468,626,3096
E02005836,1317,682,531,612,3142
E02005837,1092,550,374,380,2396
E02005838,1230,547,416,463,2656
E02005839,1098,431,330,476,2335
E02005840,1426,396,266,296,2384
E02005842,1317,521,401,592,2831
E02005843,989,294,196,249,1728
E02005844,1395,457,331,406,2589
E02005846,887,223,178,235,1523
E02005847,1027,374,304,403,2108
E02005848,999,423,350,409,2181
E02005849,1650,698,487,512,3347
E02006903,1796,761,555,751,3863
E02005850,1066,516,360,397,2339
E02005851,777,336,246,322,1681
E02005852,1398,633,497,557,3085
E02005853,1574,597,398,446,3015
E02005856,1199,596,389,583,2767
E02005857,832,293,245,282,1652
E02005858,1211,339,218,314,2082
E02005859,1274,454,337,474,2539
E02005860,1281,348,291,432,2352
E02005861,821,244,164,227,1456
E02005862,1081,426,341,463,2311
E02005863,1234,477,378,649,2738
E02005864,1240,403,293,457,2393
E02006906,2016,826,554,688,4084
E02005865,1464,615,505,584,3168
E02005866,1728,657,451,597,3433
E02005868,1265,407,292,404,2368
E02005869,919,266,157,301,1643
E02005870,917,273,179,341,1710
E02005871,1319,515,359,429,2622
E02005872,1024,420,360,498,2302
E02005873,1799,683,495,719,3696
E02005874,1553,511,322,498,2884
E02005875,1247,372,270,382,2271
E02005876,1391,478,373,540,2782
E02005877,1110,336,237,328,2011
E02005878,1458,490,344,540,2832
E02005879,965,260,186,218,1629
E02006835,1101,303,194,257,1855
E02005880,947,288,274,304,1813
E02005881,1138,290,232,252,1912
E02005882,1649,519,410,424,3002
E02005883,1540,329,280,302,2451
E02005884,1219,325,256,259,2059
E02005885,1584,459,335,440,2818
E02005886,2182,535,445,502,3664
E02005887,1231,264,237,375,2107
E02005888,1162,254,196,245,1857
E02005889,1797,502,399,516,3214
E02005890,1390,404,321,308,2423
E02005891,1102,195,188,242,1727
E02005892,2371,691,492,727,4281
E02005893,1834,563,404,473,3274
E02005894,2150,534,426,554,3664
E02005895,1450,666,481,521,3118
E02005896,1248,685,512,559,3004
E02005897,1743,599,428,537,3307
E02005898,2168,462,359,486,3475
E02005899,1300,480,350,437,2567
E02005900,1024,588,512,679,2803
E02005901,1297,418,343,444,2502
E02005902,1218,474,306,460,2458
E02005903,1671,669,559,628,3527
E02005904,1589,568,414,519,3090
E02005905,1066,491,337,467,2361
E02005906,1168,500,357,485,2510
E02005907,1445,546,472,574,3037
E02005908,1422,647,509,818,3396
E02005909,1163,326,199,266,1954
E02005910,1170,261,158,318,1907
E02005911,1379,422,261,342,2404
E02005912,1446,476,332,608,2862
E02005913,1344,399,304,524,2571
E02005914,1262,358,288,374,2282
E02005915,967,458,326,337,2088
E02005916,1232,389,307,410,2338
E02005917,866,492,383,575,2316
E02005918,737,343,314,434,1828
E02005919,1012,390,313,320,2035
E02005920,1231,589,449,505,2774
E02003237,817,424,330,430,2001
E02003238,826,214,129,172,1341
E02003239,1168,530,358,519,2575
E02003240,717,323,204,247,1491
E02003241,1068,399,320,363,2150
E02003242,1052,482,413,583,2530
E02003243,1033,290,178,278,1779
E02003244,885,281,233,393,1792
E02003245,888,221,139,156,1404
E02003246,712,219,119,185,1235
E02003247,1180,382,240,255,2057
E02003248,759,226,169,349,1503
E02003249,1130,376,278,360,2144
E02003250,755,202,131,322,1410
E02003251,1342,508,428,605,2883
E02003252,1162,278,169,311,1920
E02003253,990,286,224,315,1815
E02003254,1363,600,393,576,2932
E02003255,1348,479,367,583,2777
E02003257,1055,323,192,232,1802
E02006877,1186,304,279,373,2142
E02006878,1185,169,108,185,1647
E02003258,1221,432,366,470,2489
E02003259,804,207,204,272,1487
E02003260,936,237,128,170,1471
E02003261,793,280,313,463,1849
E02003262,1185,332,279,375,2171
E02003263,1268,350,341,587,2546
E02003264,1182,322,237,444,2185
E02003265,1138,458,305,389,2290
E02003266,1249,232,187,310,1978
E02003267,1135,221,172,250,1778
E02003268,1120,211,170,310,1811
E02003269,1138,364,299,441,2242
E02003270,1381,280,246,494,2401
E02003271,1336,367,216,251,2170
E02003272,849,181,116,208,1354
E02003273,1378,325,196,305,2204
E02003274,736,98,108,197,1139
E02003275,950,188,124,237,1499
E02003276,580,116,84,153,933
E02003277,1091,263,152,263,1769
E02003278,908,212,150,165,1435
E02003279,1177,664,550,757,3148
E02003280,1518,582,426,589,3115
E02003281,1169,695,557,775,3196
E02003282,1604,509,419,593,3125
E02003283,1398,545,395,584,2922
E02003284,1747,418,288,374,2827
E02003285,1595,267,188,224,2274
E02003286,1053,540,403,562,2558
E02003287,1392,635,438,723,3188
E02003288,1806,357,219,348,2730
E02003289,1042,386,322,463,2213
E02003290,1374,484,343,694,2895
E02003291,1490,615,417,444,2966
E02003292,1650,332,234,275,2491
E02003293,1531,408,299,559,2797
E02003294,1329,623,551,787,3290
E02003295,1299,548,403,542,2792
E02003296,874,541,309,378,2102
E02003297,865,435,337,392,2029
E02003298,840,457,303,445,2045
E02003299,874,356,232,358,1820
E02003300,891,417,289,287,1884
E02003301,1210,407,266,295,2178
E02003302,1090,287,171,221,1769
E02003303,1002,347,187,268,1804
E02003304,1082,490,301,524,2397
E02003305,744,377,275,335,1731
E02003307,1229,401,302,575,2507
E02003308,955,296,175,168,1594
E02003309,855,353,239,358,1805
E02003310,1144,210,116,130,1600
E02003311,795,230,174,312,1511
E02003312,585,132,100,97,914
E02003313,1444,359,233,321,2357
E02006859,591,86,50,34,761
E02006926,740,167,105,115,1127
E02003616,869,390,302,359,1920
E02003617,1374,607,440,557,2978
E02003618,1343,532,348,513,2736
E02003619,1719,644,486,554,3403
E02003620,1244,559,348,603,2754
E02003621,1277,619,439,593,2928
E02003622,1239,345,265,444,2293
E02003623,1661,556,379,506,3102
E02003624,752,226,193,397,1568
E02003625,1081,301,228,486,2096
E02003626,790,234,165,202,1391
E02003627,1135,299,224,388,2046
E02003628,844,181,100,224,1349
E02003629,1237,278,223,388,2126
E02003630,1401,223,153,230,2007
E02003631,923,282,184,239,1628
E02003632,1058,259,170,236,1723
E02003633,1590,393,289,292,2564
E02003634,1855,593,372,490,3310
E02003635,1211,328,267,355,2161
E02003599,626,229,148,192,1195
E02003600,749,377,262,282,1670
E02003601,895,508,314,353,2070
E02003602,774,416,337,378,1905
E02003603,1198,504,335,430,2467
E02003604,1166,382,322,379,2249
E02003605,1008,461,363,366,2198
E02003606,984,516,384,468,2352
E02003607,1306,501,361,421,2589
E02003608,1506,570,405,517,2998
E02003609,1410,487,353,476,2726
E02003610,942,393,312,480,2127
E02003611,1114,493,369,480,2456
E02003612,1440,510,415,433,2798
E02003613,571,267,207,333,1378
E02003614,897,372,246,240,1755
E02003615,1163,591,413,483,2650
E02003636,889,359,301,353,1902
E02003637,1350,575,453,553,2931
E02003638,934,507,329,408,2178
E02003639,1083,397,298,509,2287
E02003640,751,407,251,351,1760
E02003641,684,363,244,195,1486
E02003642,1111,268,148,177,1704
E02003643,1442,381,303,368,2494
E02003644,1135,343,238,343,2059
E02003645,846,289,239,451,1825
E02003646,1300,454,328,352,2434
E02003647,1136,416,292,509,2353
E02003648,619,209,148,269,1245
E02003649,873,412,343,380,2008
E02003650,972,533,398,470,2373
E02003651,992,469,366,400,2227
E02003719,1081,248,224,351,1904
E02003720,963,322,236,380,1901
E02003721,1025,294,221,470,2010
E02003722,1035,379,282,395,2091
E02003723,956,207,160,264,1587
E02003724,1152,279,150,276,1857
E02003725,1303,359,272,421,2355
E02003726,867,230,157,161,1415
E02003727,1206,170,138,199,1713
E02003728,1267,265,213,296,2041
E02003729,1472,386,300,347,2505
E02003730,2305,321,316,419,3361
E02003731,1894,355,251,485,2985
E02003732,1265,426,327,462,2480
E02003733,1242,545,354,418,2559
E02003734,1488,591,433,700,3212
E02003735,1041,425,361,485,2312
E02003736,1433,652,488,516,3089
E02003737,1458,607,402,625,3092
E02003738,851,376,260,337,1824
E02003739,869,370,284,425,1948
E02003740,947,383,304,450,2084
E02006825,1094,435,287,411,2227
E02003742,790,541,386,467,2184
E02003743,836,464,348,532,2180
E02003744,1104,673,512,738,3027
E02003745,1197,656,495,528,2876
E02003746,1127,373,315,405,2220
E02003747,1806,754,568,799,3927
E02003748,1157,519,404,501,2581
E02003749,944,375,262,275,1856
E02003750,1183,494,432,608,2717
E02003751,1290,490,356,465,2601
E02003752,1682,559,454,594,3289
E02003753,1391,623,379,498,2891
E02003754,753,391,260,300,1704
E02003755,1341,505,351,478,2675
E02003756,940,407,315,353,2015
E02003757,909,377,315,315,1916
E02003758,1145,522,404,445,2516
E02003759,739,418,276,308,1741
E02003760,1052,220,142,241,1655
E02003761,816,413,316,441,1986
E02003762,1469,532,439,521,2961
E02003763,1088,548,345,355,2336
E02003764,1423,298,230,411,2362
E02003765,754,434,354,529,2071
E02003766,992,363,245,312,1912
E02003767,770,410,310,350,1840
E02003768,1219,716,574,691,3200
E02003769,814,498,439,403,2154
E02003770,1137,512,347,366,2362
E02003771,635,315,244,390,1584
E02003772,695,468,357,398,1918
E02003773,1087,466,349,411,2313
E02003774,574,330,259,349,1512
E02003775,1099,434,297,346,2176
E02003776,1025,406,274,414,2119
E02003777,1201,361,285,335,2182
E02003778,916,293,220,280,1709
E02003779,686,299,212,208,1405
E02003780,1431,501,335,630,2897
E02003781,834,273,231,292,1630
E02003783,907,377,313,601,2198
E02003784,1015,512,375,473,2375
E02003785,1309,384,340,499,2532
E02003786,1251,369,318,541,2479
E02003787,901,516,375,512,2304
E02003788,1057,392,381,431,2261
E02003789,1439,438,315,456,2648
E02003790,1771,629,429,664,3493
E02003791,1375,443,366,448,2632
E02003792,1434,619,472,590,3115
E02003793,1036,435,311,326,2108
E02006873,917,116,97,138,1268
E02006874,1373,397,287,349,2406
E02004424,712,441,320,381,1854
E02004425,700,371,239,417,1727
E02004426,739,393,324,538,1994
E02004427,791,497,427,658,2373
E02004428,780,368,288,532,1968
E02004429,822,565,407,600,2394
E02004430,1084,416,322,352,2174
E02004431,1053,384,271,276,1984
E02004432,725,375,305,356,1761
E02004433,898,396,269,359,1922
E02004434,1110,385,238,248,1981
E02004435,1078,289,198,298,1863
E02004436,963,347,199,197,1706
E02004437,952,466,288,387,2093
E02004438,965,299,201,455,1920
E02004439,846,225,153,206,1430
E02004440,999,260,217,394,1870
E02004441,1102,418,288,292,2100
E02004442,821,262,175,232,1490
E02004443,1288,354,243,431,2316
E02004444,1027,426,283,364,2100
E02004445,875,346,250,271,1742
E02004446,916,471,292,337,2016
E02004447,933,469,351,347,2100
E02004448,835,425,340,434,2034
E02004449,1075,413,343,384,2215
E02004450,716,459,315,362,1852
E02004451,1269,591,453,591,2904
E02004452,1109,584,387,570,2650
E02004453,770,274,256,313,1613
E02004454,998,409,305,423,2135
E02004455,892,463,317,305,1977
E02004456,1045,370,282,320,2017
E02004457,1155,471,318,443,2387
E02004458,1007,454,333,465,2259
E02004459,1527,694,457,641,3319
E02004460,1044,532,398,385,2359
E02004461,620,262,137,130,1149
E02004462,1221,492,371,575,2659
E02004463,1184,471,361,475,2491
E02004464,911,649,540,715,2815
E02004465,543,366,292,507,1708
E02004466,956,353,274,480,2063
E02004467,870,380,262,361,1873
E02004468,1107,534,490,838,2969
E02004469,789,375,274,378,1816
E02004470,952,383,288,586,2209
E02004471,950,356,257,445,2008
E02004472,709,353,188,396,1646
E02004473,969,456,367,501,2293
E02004474,1152,510,419,566,2647
E02004475,884,430,360,417,2091
E02004476,1032,537,420,530,2519
E02004477,935,471,372,532,2310
E02004478,893,381,296,552,2122
E02004479,1012,514,396,544,2466
E02004480,771,413,263,185,1632
E02004481,725,658,542,653,2578
E02004482,914,401,261,298,1874
E02004483,972,647,472,515,2606
E02004484,940,609,426,467,2442
E02004485,993,457,326,358,2134
E02004486,1207,494,386,571,2658
E02004487,779,395,285,365,1824
E02004488,1262,484,304,435,2485
E02004489,1258,452,294,366,2370
E02004490,914,288,214,306,1722
E02004491,1010,333,252,375,1970
E02004492,1012,330,211,263,1816
E02004493,1092,336,246,413,2087
E02004494,1173,316,245,511,2245
E02004495,761,527,470,730,2488
E02004496,739,342,285,511,1877
E02004497,848,498,465,716,2527
E02004498,965,489,350,493,2297
E02004499,858,387,279,337,1861
E02004500,1381,628,518,639,3166
E02004501,826,480,355,453,2114
E02004502,759,440,395,543,2137
E02004503,935,542,332,352,2161
E02004504,987,457,238,269,1951
E02004505,742,497,354,472,2065
E02004506,1109,465,317,442,2333
E02004507,1633,317,205,237,2392
E02004508,1057,451,335,398,2241
E02004509,2534,408,248,346,3536
E02004512,1533,412,335,600,2880
E02004513,1327,326,229,266,2148
E02004514,996,325,231,418,1970
E02004515,1393,504,355,380,2632
E02004516,1835,291,184,206,2516
E02004517,1460,541,406,605,3012
E02004518,1052,308,208,259,1827
E02004519,1350,474,379,628,2831
E02004520,1278,238,163,186,1865
E02004521,1720,423,271,377,2791
E02004522,1411,522,407,437,2777
E02004523,1684,366,237,325,2612
E02004524,1393,599,410,438,2840
E02004525,1101,630,495,547,2773
E02004526,1073,725,561,742,3101
E02006922,2429,790,683,895,4797
E02004527,1201,513,407,495,2616
E02004528,1107,539,417,570,2633
E02004529,788,434,313,384,1919
E02004530,728,399,287,478,1892
E02004531,959,383,252,431,2025
E02004532,826,355,257,359,1797
E02004533,981,382,288,446,2097
E02004534,1084,352,298,340,2074
E02004535,795,327,252,332,1706
E02004536,803,410,271,427,1911
E02004537,881,268,205,296,1650
E02004538,1057,461,337,539,2394
E02004539,799,288,237,337,1661
E02004540,720,260,216,317,1513
E02004541,1177,544,454,632,2807
E02004542,1118,365,234,387,2104
E02004543,880,275,223,339,1717
E02004544,1230,393,273,379,2275
E02004545,1087,267,164,310,1828
E02004546,1045,245,179,301,1770
E02004547,1432,248,175,327,2182
E02004548,1343,279,198,214,2034
E02004549,1028,255,193,378,1854
E02004550,1153,275,221,447,2096
E02004551,1027,281,223,346,1877
E02004552,981,382,242,262,1867
E02004553,922,241,203,295,1661
E02004554,1019,296,223,270,1808
E02004555,1094,515,331,377,2317
E02004556,1094,584,504,529,2711
E02004557,1560,519,316,446,2841
E02004558,1140,410,352,630,2532
E02004559,1406,557,429,525,2917
E02004560,1135,593,419,498,2645
E02004561,1453,732,536,614,3335
E02004562,987,587,482,521,2577
E02004563,1075,614,461,559,2709
E02004564,1244,533,388,536,2701
E02004565,2290,922,803,1008,5023
E02004566,765,280,180,279,1504
E02004567,1077,528,396,620,2621
E02004568,1143,405,280,313,2141
E02004569,1226,420,333,463,2442
E02004570,1117,553,435,684,2789
E02004571,1006,541,426,599,2572
E02004572,1178,503,314,388,2383
E02004573,1034,320,218,348,1920
E02004574,1246,445,338,430,2459
E02004575,1988,745,566,798,4097
E02004576,1785,654,538,684,3661
E02004577,1092,343,254,307,1996
E02004578,1160,731,580,836,3307
E02004579,1444,656,490,546,3136
E02004580,2036,1307,987,1425,5755
E02004581,1456,658,513,579,3206
E02004582,1183,647,532,644,3006
E02004583,1484,697,530,630,3341
E02004584,1106,831,656,867,3460
E02004585,1544,679,489,514,3226
E02004586,1482,592,468,758,3300
E02004587,1404,433,368,429,2634
E02004588,1326,338,271,503,2438
E02004589,1365,486,393,587,2831
E02004590,1557,772,628,732,3689
E02004591,764,439,320,394,1917
E02004592,1262,638,500,895,3295
E02004593,909,583,389,506,2387
E02004594,818,472,378,473,2141
E02004595,1413,759,526,670,3368
E02004596,971,461,330,401,2163
E02004597,998,429,324,456,2207
E02004598,1250,571,465,606,2892
E02004599,876,441,346,436,2099
E02004843,812,426,362,454,2054
E02004844,775,255,198,328,1556
E02004845,809,380,290,491,1970
E02004846,653,372,306,429,1760
E02004847,928,405,276,370,1979
E02004848,727,352,255,300,1634
E02004849,730,352,243,351,1676
E02004850,702,312,247,386,1647
E02004851,575,285,212,255,1327
E02004852,674,318,244,493,1729
E02004853,686,306,213,340,1545
E02004854,726,301,242,480,1749
E02004855,641,200,180,232,1253
E02004856,765,263,178,239,1445
E02004857,703,333,212,368,1616
E02004858,548,239,182,200,1169
E02004859,565,358,226,304,1453
E02004860,720,210,123,97,1150
E02004861,651,382,268,465,1766
E02004862,1110,372,194,188,1864
E02004863,1064,221,189,359,1833
E02004864,665,327,241,433,1666
E02004865,743,211,136,243,1333
E02004866,878,236,183,315,1612
E02004867,689,324,204,325,1542
E02004868,933,229,181,335,1678
E02004869,584,249,188,298,1319
E02004870,1518,330,265,522,2635
E02004871,684,181,156,243,1264
E02004872,1012,368,309,487,2176
E02004873,1394,450,329,426,2599
E02004874,809,240,158,210,1417
E02004875,1231,351,236,301,2119
E02004876,1434,510,449,501,2894
E02004877,809,259,224,392,1684
E02004896,1043,434,392,792,2661
E02004897,849,360,240,337,1786
E02004898,1077,334,269,383,2063
E02004899,826,293,178,279,1576
E02004900,1520,404,341,550,2815
E02004901,1262,286,208,300,2056
E02004902,1165,303,189,254,1911
E02004903,1231,277,167,292,1967
E02004904,908,225,147,186,1466
E02004905,1375,324,219,351,2269
E02004906,1549,353,231,328,2461
E02004907,1920,528,399,516,3363
E02004908,2140,568,559,912,4179
E02004909,755,248,157,252,1412
E02004910,1519,739,497,668,3423
E02004911,919,263,211,426,1819
E02004912,1334,452,343,595,2724
E02004913,2000,659,510,671,3840
E02004914,1030,343,234,353,1960
E02004915,690,223,196,267,1376
E02004916,993,471,357,578,2399
E02004917,880,402,292,435,2009
E02004918,817,239,173,280,1509
E02004919,760,321,243,298,1622
E02004920,1125,558,419,841,2943
E02004921,834,351,298,470,1953
E02004922,1109,593,460,518,2680
E02004923,1273,583,442,723,3021
E02004956,1232,431,360,483,2506
E02004957,1384,410,280,282,2356
E02004958,1024,402,298,457,2181
E02004959,1034,327,236,570,2167
E02004960,751,292,227,347,1617
E02004961,1225,464,303,480,2472
E02004962,1302,388,292,448,2430
E02004963,1135,295,186,234,1850
E02004964,905,241,174,239,1559
E02004965,1068,372,350,488,2278
E02004966,1774,429,309,491,3003
E02004967,1162,201,136,232,1731
E02004968,876,266,202,290,1634
E02004969,928,240,227,317,1712
E02004970,996,293,222,379,1890
E02004971,1156,215,189,262,1822
E02004972,918,260,198,274,1650
E02004973,1029,179,82,125,1415
E02004974,1118,363,277,510,2268
E02004975,1141,330,261,381,2113
E02004976,1210,194,139,223,1766
E02004977,1270,164,114,158,1706
E02004978,1351,206,159,283,1999
E02004979,1208,303,218,249,1978
E02005503,1094,528,410,529,2561
E02005504,1697,720,570,670,3657
E02005505,1102,456,397,611,2566
E02005506,1214,496,384,482,2576
E02005507,1831,719,597,791,3938
E02005508,1190,585,415,457,2647
E02005509,1409,640,565,881,3495
E02005510,1189,630,498,569,2886
E02005511,1239,657,548,760,3204
E02005512,1288,603,373,414,2678
E02005513,1313,622,516,684,3135
E02005514,1105,552,362,421,2440
E02005515,904,382,293,423,2002
E02005516,955,553,347,462,2317
E02005517,978,202,134,177,1491
E02005518,1883,499,355,560,3297
E02005519,1438,323,234,359,2354
E02005520,1014,756,559,707,3036
E02005521,1052,663,449,517,2681
E02005522,763,379,278,372,1792
E02005523,1127,505,332,369,2333
E02005524,754,402,301,387,1844
E02005525,1392,544,462,606,3004
E02005526,823,344,244,462,1873
E02005527,1380,573,461,675,3089
E02005528,1327,558,431,603,2919
E02005529,1096,443,346,639,2524
E02005530,962,324,312,433,2031
E02005531,735,316,240,404,1695
E02005532,1229,625,454,752,3060
E02005533,1415,666,547,627,3255
E02005534,1077,460,395,604,2536
E02005535,1022,371,224,423,2040
E02005536,1033,467,350,493,2343
E02005537,976,448,334,479,2237
E02005538,1686,841,646,710,3883
E02005539,1277,650,494,491,2912
E02005540,1351,780,649,768,3548
E02005541,844,341,303,403,1891
E02005542,832,296,194,240,1562
E02005543,981,243,206,254,1684
E02005544,921,256,191,202,1570
E02005545,1082,521,397,497,2497
E02005546,1306,424,304,416,2450
E02005547,1453,489,409,594,2945
E02005548,1280,378,290,490,2438
E02005549,991,479,328,345,2143
E02005550,1185,510,381,557,2633
E02005551,784,603,429,716,2532
E02005552,1283,611,471,613,2978
E02005553,1371,1028,784,946,4129
E02005554,1212,665,560,715,3152
E02005555,1343,530,421,548,2842
E02005556,1445,432,348,504,2729
E02005557,789,189,153,168,1299
E02005558,1282,497,410,508,2697
E02005559,1190,326,234,422,2172
E02005560,1787,277,229,272,2565
E02005561,1497,403,335,478,2713
E02005562,1505,579,432,485,3001
E02005563,1109,520,376,471,2476
E02005564,1440,598,478,643,3159
E02005565,1140,449,350,413,2352
E02005566,1387,650,511,624,3172
E02005567,1482,743,651,1196,4072
E02005568,1007,547,389,539,2482
E02005569,1052,487,356,447,2342
E02005570,1057,726,589,910,3282
E02005571,906,521,431,644,2502
E02005572,1378,742,554,777,3451
E02005573,783,601,493,776,2653
E02005574,1235,649,477,599,2960
E02005575,1070,665,452,545,2732
E02005576,804,675,473,629,2581
E02005577,808,515,338,435,2096
E02005578,894,401,299,349,1943
E02005579,1735,933,756,1215,4639
E02005580,1130,593,485,731,2939
E02005581,1015,589,401,396,2401
E02005582,832,518,395,542,2287
E02005583,1445,873,654,936,3908
E02005584,1668,388,286,373,2715
E02005585,1399,330,268,332,2329
E02005586,1586,305,194,244,2329
E02005587,1358,386,338,637,2719
E02005588,2366,447,298,430,3541
E02005589,2055,402,280,372,3109
E02005590,1565,449,346,443,2803
E02005592,1438,364,201,280,2283
E02005593,1823,242,178,349,2592
E02005594,1583,550,343,537,3013
E02005595,1627,613,549,854,3643
E02005596,1655,447,303,480,2885
E02006907,853,210,203,298,1564
E02006908,784,215,154,177,1330
E02005597,2718,790,584,812,4904
E02005598,1742,546,410,644,3342
E02005599,1145,445,355,482,2427
E02005600,935,439,346,404,2124
E02005601,853,436,387,517,2193
E02005602,1878,829,660,904,4271
E02005603,1867,558,415,572,3412
E02005604,1262,600,488,653,3003
E02005605,1601,665,539,656,3461
E02005606,1001,421,316,333,2071
E02005607,1721,781,557,651,3710
E02005608,1156,619,431,561,2767
E02005609,995,580,438,625,2638
E02005610,1167,674,435,537,2813
E02005611,1257,639,542,888,3326
E02006227,975,588,399,517,2479
E02006228,999,446,319,339,2103
E02006229,1053,512,418,519,2502
E02006230,1630,775,608,884,3897
E02006231,1495,462,348,429,2734
E02006232,1154,488,361,379,2382
E02006233,2064,666,605,889,4224
E02006234,1829,557,403,484,3273
E02006235,1194,653,475,610,2932
E02006236,1613,833,662,776,3884
E02006237,1236,516,385,590,2727
E02006245,1429,372,358,522,2681
E02006246,1493,411,292,483,2679
E02006247,1414,351,223,294,2282
E02006248,1576,385,279,420,2660
E02006249,1641,425,301,530,2897
E02006250,1360,244,172,179,1955
E02006251,1585,258,149,218,2210
E02006252,1899,333,262,422,2916
E02006253,1572,484,346,618,3020
E02006254,1326,268,204,382,2180
E02006255,1330,286,176,287,2079
E02006256,1362,316,206,320,2204
E02006257,1230,328,272,494,2324
E02006258,1571,348,214,353,2486
E02006259,1248,403,285,325,2261
E02006260,1494,326,241,339,2400
E02006261,1368,695,463,610,3136
E02006262,1452,730,542,566,3290
E02006263,1415,625,482,540,3062
E02006264,2124,587,416,541,3668
E02006265,1353,503,417,506,2779
E02006266,2618,725,541,698,4582
E02006267,1612,643,391,503,3149
E02006268,1116,409,296,507,2328
E02006269,1389,464,325,451,2629
E02006270,2135,483,347,485,3450
E02006271,1502,557,435,550,3044
E02006272,1456,574,415,573,3018
E02004924,696,313,244,335,1588
E02004925,734,253,210,358,1555
E02004926,720,386,305,594,2005
E02004927,648,364,286,424,1722
E02004928,743,369,284,408,1804
E02004929,766,398,325,424,1913
E02004930,925,293,239,348,1805
E02004931,846,290,199,370,1705
E02004932,944,283,205,262,1694
E02004933,829,283,203,318,1633
E02004934,781,228,136,273,1418
E02004935,849,189,150,250,1438
E02004936,692,204,132,181,1209
E02004937,882,421,363,581,2247
E02004938,748,253,164,256,1421
E02004939,732,254,175,401,1562
E02004940,769,241,165,292,1467
E02004941,1398,391,254,345,2388
E02004942,915,346,276,399,1936
E02004943,1203,503,417,586,2709
E02004980,748,379,302,398,1827
E02004981,921,367,273,439,2000
E02004982,637,275,225,365,1502
E02004983,735,239,194,319,1487
E02004984,843,278,187,320,1628
E02004985,707,394,318,618,2037
E02004986,852,186,126,175,1339
E02004987,853,249,167,299,1568
E02004988,857,224,175,273,1529
E02004989,1030,288,215,297,1830
E02004990,694,275,196,377,1542
E02004991,728,149,124,239,1240
E02004992,820,176,119,262,1377
E02004993,623,274,212,288,1397
E02004994,725,306,269,388,1688
E02004995,629,315,259,457,1660
E02004878,966,510,368,458,2302
E02004879,1061,541,350,456,2408
E02004880,1209,473,319,418,2419
E02004881,718,318,171,476,1683
E02004882,971,359,223,390,1943
E02004883,585,343,261,291,1480
E02004884,1297,348,231,433,2309
E02004885,1051,362,259,324,1996
E02004886,885,358,243,343,1829
E02004887,995,501,308,390,2194
E02004888,1297,539,389,537,2762
E02004889,1192,463,374,787,2816
E02004890,967,448,274,357,2046
E02004891,943,430,312,458,2143
E02004892,722,185,178,239,1324
E02004893,649,163,130,132,1074
E02004894,1020,396,305,501,2222
E02004895,1087,477,389,437,2390
E02004944,1008,237,143,175,1563
E02004945,1748,487,391,535,3161
E02004946,773,231,190,279,1473
E02004947,924,273,194,237,1628
E02004948,781,306,178,240,1505
E02004949,1063,329,296,495,2183
E02004950,811,229,190,308,1538
E02004951,907,218,170,321,1616
E02004952,879,223,161,309,1572
E02004953,744,183,165,234,1326
E02004954,850,260,180,301,1591
E02004955,784,261,159,266,1470
E02006287,1384,615,438,514,2951
E02006288,1752,741,538,725,3756
E02006289,2724,758,580,747,4809
E02006290,1981,620,509,783,3893
E02006291,1455,623,446,538,3062
E02006292,1367,513,384,432,2696
E02006293,1906,675,443,539,3563
E02006294,1337,620,527,916,3400
E02006295,1782,621,493,757,3653
E02006296,2502,793,546,692,4533
E02006297,1683,549,412,634,3278
E02006298,2012,661,413,464,3550
E02006299,1979,839,713,1057,4588
E02006300,1524,407,338,370,2639
E02006301,1257,473,311,547,2588
E02006302,1033,589,466,593,2681
E02006303,1152,357,296,361,2166
E02006304,1252,698,578,701,3229
E02006305,1266,327,262,294,2149
E02006306,1137,507,391,505,2540
E02006307,1116,744,506,720,3086
E02006308,1166,363,250,348,2127
E02006309,990,492,391,606,2479
E02006310,1179,436,378,486,2479
E02006311,1289,615,522,748,3174
E02006312,1408,650,486,598,3142
E02006313,1513,817,658,767,3755
E02006314,1190,541,364,599,2694
E02006315,1006,509,419,578,2512
E02006316,1270,613,502,755,3140
E02006238,1543,596,469,649,3257
E02006239,745,310,226,314,1595
E02006240,1201,424,253,309,2187
E02006241,1279,463,354,513,2609
E02006242,1332,420,285,319,2356
E02006243,1503,399,306,395,2603
E02006273,1022,559,419,484,2484
E02006274,833,365,286,395,1879
E02006275,1124,287,251,323,1985
E02006276,1329,537,435,635,2936
E02006277,1294,297,200,265,2056
E02006278,1343,421,357,522,2643
E02006279,1535,614,467,688,3304
E02006280,1611,694,577,716,3598
E02006281,1629,609,547,924,3709
E02006282,966,538,444,512,2460
E02006283,1078,448,381,382,2289
E02006284,1297,383,282,389,2351
E02006285,1200,267,203,261,1931
E02006286,1740,553,384,450,3127
E02006826,1483,461,304,594,2842
E02000001,846,295,194,241,1576
E02000002,778,163,156,294,1391
E02000003,1161,269,203,313,1946
E02000004,982,200,163,285,1630
E02000005,1157,194,145,216,1712
E02000007,1044,231,146,244,1665
E02000008,1465,259,184,274,2182
E02000009,1222,174,116,173,1685
E02000010,1069,160,119,199,1547
E02000011,756,172,147,275,1350
E02000012,1384,242,153,305,2084
E02000013,1030,210,124,188,1552
E02000014,1134,251,163,225,1773
E02000015,865,179,111,170,1325
E02000016,848,79,52,43,1022
E02000017,1027,154,109,155,1445
E02000018,1078,181,108,172,1539
E02000019,1094,202,120,168,1584
E02000020,1397,198,125,228,1948
E02000021,920,178,108,180,1386
E02000022,703,55,42,46,846
E02000023,825,91,38,73,1027
E02006799,1347,217,173,252,1989
E02000024,1590,535,391,580,3096
E02000025,1145,336,237,335,2053
E02000026,1143,290,239,325,1997
E02000027,1400,366,268,385,2419
E02000028,974,245,191,329,1739
E02000029,1178,288,219,267,1952
E02000030,1670,487,360,563,3080
E02000031,1229,340,264,528,2361
E02000032,1444,379,264,396,2483
E02000033,1237,306,218,312,2073
E02000034,1279,339,279,362,2259
E02000035,1210,318,268,423,2219
E02000036,1876,366,295,404,2941
E02000037,2091,479,303,429,3302
E02000038,1481,347,256,435,2519
E02000039,1256,310,200,272,2038
E02000040,1132,310,265,325,2032
E02000041,1544,315,217,377,2453
E02000042,1417,349,284,473,2523
E02000043,1123,304,202,314,1943
E02000044,1608,221,148,174,2151
E02000045,1229,283,174,236,1922
E02000046,912,211,165,229,1517
E02000047,2124,310,172,308,2914
E02000048,1569,403,332,488,2792
E02000049,1481,162,115,113,1871
E02000050,1362,346,246,307,2261
E02000051,1542,389,339,521,2791
E02000052,1347,289,238,295,2169
E02000053,2188,221,144,227,2780
E02000054,1091,204,159,208,1662
E02000055,1527,282,230,413,2452
E02000056,2012,452,311,506,3281
E02000057,1217,207,155,234,1813
E02000058,2017,436,369,499,3321
E02000059,1744,270,193,335,2542
E02000060,1766,294,216,506,2782
E02000061,1419,287,201,409,2316
E02000062,821,155,74,131,1181
E02000063,1058,214,135,230,1637
E02000064,828,161,128,180,1297
E02000065,1082,137,102,94,1415
E02000066,1345,263,169,180,1957
E02000067,1168,270,170,244,1852
E02000068,874,168,118,215,1375
E02000069,887,243,211,325,1666
E02000070,1264,381,309,444,2398
E02000071,1105,301,186,280,1872
E02000072,1388,233,133,254,2008
E02000073,1630,540,393,590,3153
E02000074,1132,285,206,295,1918
E02000075,1217,460,341,507,2525
E02000077,1276,345,225,413,2259
E02000078,1166,369,290,408,2233
E02000079,1117,339,285,623,2364
E02000080,1355,415,287,492,2549
E02000081,1141,398,283,510,2332
E02000082,1414,395,262,404,2475
E02000083,1351,381,282,341,2355
E02000084,1627,535,397,536,3095
E02000085,1113,344,261,355,2073
E02000086,1130,375,280,317,2102
E02000087,1184,393,333,595,2505
E02000088,1126,342,330,403,2201
E02000089,1201,367,298,514,2380
E02000090,1250,426,361,631,2668
E02000091,1476,539,407,822,3244
E02000092,974,284,191,300,1749
E02006785,963,272,222,330,1787
E02000093,2346,355,289,433,3423
E02000094,1866,238,200,277,2581
E02000095,2000,342,240,356,2938
E02000096,1672,408,276,422,2778
E02000097,1957,268,225,324,2774
E02000098,1393,303,213,362,2271
E02000099,1310,209,157,260,1936
E02000100,2071,324,283,382,3060
E02000101,1387,263,216,310,2176
E02000102,1024,162,125,198,1509
E02000103,1300,219,179,269,1967
E02000104,1369,212,197,328,2106
E02000105,1515,231,164,255,2165
E02000106,1215,251,155,251,1872
E02000107,1221,252,186,192,1851
E02000108,1183,200,134,205,1722
E02000109,1791,220,201,310,2522
E02000110,1061,252,162,191,1666
E02000111,1664,284,172,287,2407
E02000112,1860,218,184,321,2583
E02000113,1212,169,116,173,1670
E02000114,1013,192,113,184,1502
E02000115,841,204,134,191,1370
E02000116,924,138,110,127,1299
E02000117,1449,200,169,257,2075
E02000118,1555,224,162,254,2195
E02000119,1212,144,100,181,1637
E02000120,878,224,131,181,1414
E02000121,1531,264,174,257,2226
E02000122,1063,222,161,255,1701
E02000123,1383,204,149,206,1942
E02000124,1043,225,152,203,1623
E02000125,1162,210,158,272,1802
E02000126,714,130,101,124,1069
E02000127,1266,302,197,307,2072
E02000128,1292,362,250,348,2252
E02000130,1270,295,206,230,2001
E02000131,1227,194,106,132,1659
E02000132,1413,369,239,381,2402
E02000133,1763,488,425,699,3375
E02000134,1517,396,275,355,2543
E02000135,1477,195,141,239,2052
E02000136,972,251,242,508,1973
E02000137,1147,400,306,519,2372
E02000138,1347,423,399,680,2849
E02000139,1337,236,151,194,1918
E02000140,1384,271,180,259,2094
E02000141,1108,211,143,200,1662
E02000142,1351,391,262,415,2419
E02000144,1253,336,242,396,2227
E02000145,1182,276,211,263,1932
E02000146,1411,303,233,469,2416
E02000147,1386,474,318,486,2664
E02000148,1116,372,302,409,2199
E02000149,1093,315,199,342,1949
E02000150,1460,367,258,406,2491
E02000151,1067,411,358,484,2320
E02000152,1174,250,186,299,1909
E02000153,1315,448,262,397,2422
E02000154,1384,401,329,435,2549
E02000155,1228,373,339,528,2468
E02000156,2245,683,523,912,4363
E02000157,1495,451,370,641,2957
E02000158,1156,392,325,474,2347
E02000159,1400,456,276,488,2620
E02000160,1437,461,287,484,2669
E02000161,1415,474,336,474,2699
E02000162,1170,386,318,603,2477
E02000163,1266,438,356,496,2556
E02000165,1184,388,249,259,2080
E02006782,1123,368,250,395,2136
E02006787,1332,342,204,306,2184
E02006789,1060,529,401,493,2483
E02000166,1215,367,257,310,2149
E02000167,1034,323,251,381,1989
E02000168,1168,240,206,233,1847
E02000169,869,264,231,344,1708
E02000170,935,215,181,228,1559
E02000171,1103,273,196,229,1801
E02000172,1242,253,159,258,1912
E02000173,1112,200,183,255,1750
E02000174,1079,195,163,179,1616
E02000175,942,212,148,150,1452
E02000176,692,191,143,201,1227
E02000177,1056,236,179,262,1733
E02000178,903,203,129,152,1387
E02000179,724,177,131,205,1237
E02000180,885,184,141,142,1352
E02000181,932,217,139,175,1463
E02000182,814,161,151,266,1392
E02000183,965,268,226,268,1727
E02000184,1006,157,106,150,1419
E02000185,946,259,179,222,1606
E02000186,742,126,116,128,1112
E02000187,1246,168,130,175,1719
E02000188,1041,130,96,139,1406
E02000189,542,122,67,105,836
E02000190,705,173,115,155,1148
E02000191,786,91,79,99,1055
E02000192,759,173,110,142,1184
E02000193,848,183,145,138,1314
E02000194,1146,250,161,252,1809
E02000195,1419,327,243,364,2353
E02000196,943,225,171,273,1612
E02000197,992,265,191,282,1730
E02000198,965,166,111,167,1409
E02000199,1007,214,139,150,1510
E02000200,927,205,143,232,1507
E02000201,693,168,103,161,1125
E02000202,995,212,146,239,1592
E02000203,853,191,132,203,1379
E02000204,1217,225,182,261,1885
E02000206,919,189,142,187,1437
E02000207,882,166,126,147,1321
E02000208,1114,159,97,157,1527
E02000209,1156,175,129,153,1613
E02000210,795,195,128,184,1302
E02000211,1204,427,334,457,2422
E02000212,949,140,100,134,1323
E02000213,961,195,133,207,1496
E02000214,764,287,182,280,1513
E02000215,997,263,180,290,1730
E02000216,716,249,205,376,1546
E02000217,965,173,106,139,1383
E02000218,817,236,162,232,1447
E02000219,1146,496,378,570,2590
E02000220,1023,200,148,261,1632
E02000221,1036,261,166,327,1790
E02000222,933,240,168,247,1588
E02000223,894,140,133,175,1342
E02000224,964,243,170,179,1556
E02000225,1070,250,187,204,1711
E02000226,1070,429,319,478,2296
E02000227,1580,575,365,469,2989
E02000228,1110,490,355,577,2532
E02000229,833,173,127,212,1345
E02000230,1439,420,317,524,2700
E02000231,1337,397,283,453,2470
E02000232,932,407,240,400,1979
E02000233,811,220,170,297,1498
E02000234,1187,397,279,346,2209
E02000235,895,329,261,316,1801
E02000236,1204,390,245,316,2155
E02000237,1110,436,376,491,2413
E02006788,745,203,94,124,1166
E02000238,1330,254,182,226,1992
E02000239,1410,305,234,343,2292
E02000240,1455,283,204,249,2191
E02000241,1026,201,137,216,1580
E02000242,972,193,121,219,1505
E02000243,1252,247,193,305,1997
E02000244,919,243,169,203,1534
E02000245,1118,166,126,170,1580
E02000246,1272,235,151,221,1879
E02000247,1402,284,182,381,2249
E02000248,915,221,148,246,1530
E02000249,1092,221,211,314,1838
E02000250,1073,315,214,339,1941
E02000251,1306,266,164,278,2014
E02000252,1103,160,140,226,1629
E02000253,1337,283,236,311,2167
E02000254,1735,296,202,313,2546
E02000255,1404,355,239,301,2299
E02000256,1205,270,178,296,1949
E02000257,1667,386,325,484,2862
E02000258,673,168,120,176,1137
E02000259,980,196,152,194,1522
E02000260,1607,299,214,330,2450
E02000261,1286,266,179,254,1985
E02000262,958,210,152,200,1520
E02000263,2031,326,237,390,2984
E02000264,1033,260,192,321,1806
E02000265,1402,293,205,284,2184
E02000266,1887,287,193,273,2640
E02000267,1000,204,151,164,1519
E02000268,1193,364,212,282,2051
E02000269,1088,268,161,251,1768
E02000270,862,147,123,171,1303
E02000271,789,265,153,201,1408
E02000272,944,266,204,291,1705
E02000274,2404,352,217,297,3270
E02000275,1514,280,166,278,2238
E02000276,776,160,146,190,1272
E02006791,841,210,160,153,1364
E02000277,1088,196,140,283,1707
E02000278,1475,224,183,274,2156
E02000279,1737,212,144,170,2263
E02000280,1839,363,272,348,2822
E02000281,1694,270,181,256,2401
E02000282,1415,193,135,188,1931
E02000283,1462,210,160,225,2057
E02000284,1779,301,223,330,2633
E02000285,1646,314,222,314,2496
E02000286,1801,399,322,533,3055
E02000287,1416,351,291,502,2560
E02000288,1789,234,195,273,2491
E02000289,1536,351,230,406,2523
E02000290,952,104,87,121,1264
E02000291,1744,304,230,438,2716
E02000292,1797,290,222,293,2602
E02000293,1407,353,272,412,2444
E02000294,1475,248,189,275,2187
E02000295,1581,271,204,465,2521
E02000296,1608,304,264,472,2648
E02000297,2012,454,327,511,3304
E02000298,1744,356,274,376,2750
E02000299,1406,198,158,248,2010
E02000300,1207,189,147,209,1752
E02000301,1475,242,136,232,2085
E02000302,1507,336,249,335,2427
E02000303,1307,194,110,183,1794
E02000304,1605,369,301,427,2702
E02000305,1652,276,202,312,2442
E02000306,1327,176,116,166,1785
E02000307,1603,287,190,311,2391
E02000308,1175,238,194,249,1856
E02000309,1465,180,132,214,1991
E02000311,1532,345,198,311,2386
E02000312,1556,290,207,387,2440
E02006793,1287,148,107,201,1743
E02000313,857,137,95,77,1166
E02000314,1509,151,97,139,1896
E02000315,1260,179,136,208,1783
E02000316,1134,203,137,103,1577
E02000317,959,151,97,140,1347
E02000318,1274,255,194,198,1921
E02000319,1163,197,132,123,1615
E02000320,919,165,116,122,1322
E02000321,847,175,110,131,1263
E02000323,1295,163,117,183,1758
E02000324,1299,184,141,192,1816
E02000326,1270,204,136,157,1767
E02000327,649,118,56,73,896
E02000328,1238,238,175,231,1882
E02000329,876,193,162,188,1419
E02000331,1285,195,142,200,1822
E02000332,974,241,183,218,1616
E02000333,1096,233,212,318,1859
E02000334,1197,228,149,222,1796
E02000335,858,301,207,284,1650
E02000337,1115,284,198,240,1837
E02000339,839,291,200,329,1659
E02000340,818,319,248,373,1758
E02000341,954,242,158,204,1558
E02000342,724,204,102,193,1223
E02000343,927,273,178,271,1649
E02000344,967,324,218,284,1793
E02006786,1032,185,140,167,1524
E02006927,1372,367,299,416,2454
E02006928,895,120,66,78,1159
E02006929,1508,176,125,149,1958
E02006930,1166,160,106,121,1553
E02006931,1039,248,177,244,1708
E02000345,547,161,75,123,906
E02000346,657,146,81,128,1012
E02000347,585,151,94,150,980
E02000348,496,137,74,116,823
E02000350,765,160,90,109,1124
E02000351,858,131,115,117,1221
E02000352,707,177,98,138,1120
E02000353,795,169,92,158,1214
E02000354,847,156,107,139,1249
E02000355,832,173,113,182,1300
E02000356,933,123,90,108,1254
E02000357,622,144,108,137,1011
E02000358,1027,202,120,137,1486
E02000359,591,114,87,105,897
E02000360,1019,188,117,146,1470
E02000361,742,107,76,115,1040
E02000362,659,118,76,110,963
E02000363,1079,182,119,153,1533
E02000364,1000,208,152,186,1546
E02000365,1277,252,178,217,1924
E02000366,981,206,134,186,1507
E02000367,1220,150,108,104,1582
E02000368,1048,183,110,164,1505
E02000369,1000,172,138,176,1486
E02000370,675,145,71,96,987
E02000371,915,144,90,129,1278
E02006918,634,99,59,80,872
E02006921,597,113,92,99,901
E02000372,1378,201,106,171,1856
E02000373,699,111,82,100,992
E02000374,776,173,98,164,1211
E02000375,834,141,78,140,1193
E02000376,765,122,72,128,1087
E02000377,958,180,104,145,1387
E02000378,761,145,102,112,1120
E02000379,910,233,171,237,1551
E02000380,714,168,107,147,1136
E02000381,933,192,139,180,1444
E02000382,780,178,127,159,1244
E02000383,1162,254,189,288,1893
E02000384,1012,184,125,221,1542
E02000385,700,104,69,81,954
E02000386,934,162,111,136,1343
E02000387,967,109,103,108,1287
E02000388,766,159,154,216,1295
E02000389,971,232,192,247,1642
E02000390,542,117,104,110,873
E02000391,655,182,132,196,1165
E02000392,745,180,134,167,1226
E02000393,486,144,109,129,868
E02000394,796,152,111,157,1216
E02000395,477,234,151,249,1111
E02000396,565,178,131,126,1000
E02000397,814,173,129,158,1274
E02000398,756,122,90,128,1096
E02000400,944,212,156,194,1506
E02000401,872,141,104,125,1242
E02000402,736,117,87,114,1054
E02000403,793,138,107,148,1186
E02000404,755,169,115,166,1205
E02000405,879,226,149,162,1416
E02000406,792,137,99,133,1161
E02000407,781,121,83,149,1134
E02000408,810,159,92,146,1207
E02000409,802,151,101,124,1178
E02000410,996,236,145,162,1539
E02000411,987,152,99,104,1342
E02000412,722,123,96,155,1096
E02000413,1065,232,197,279,1773
E02000414,816,142,85,137,1180
E02000415,776,163,87,192,1218
E02000416,1021,199,133,144,1497
E02000417,910,263,197,249,1619
E02000418,944,260,160,187,1551
E02000419,860,156,104,174,1294
E02000420,982,172,126,132,1412
E02000421,796,114,84,154,1148
E02000422,756,131,107,149,1143
E02000423,767,118,67,124,1076
E02000424,926,178,110,106,1320
E02000425,578,120,71,106,875
E02000426,1025,240,198,344,1807
E02000427,729,129,69,131,1058
E02000428,668,113,95,108,984
E02000429,957,260,171,213,1601
E02000430,951,195,125,117,1388
E02000431,753,185,125,186,1249
E02000432,728,173,88,79,1068
E02006794,787,123,70,123,1103
E02000433,1789,419,405,784,3397
E02000434,1934,388,259,518,3099
E02000435,1460,360,267,434,2521
E02000436,1387,368,271,399,2425
E02000437,1615,365,292,468,2740
E02000438,1473,312,244,482,2511
E02000439,1621,247,165,284,2317
E02000440,2148,345,259,389,3141
E02000441,1382,336,271,375,2364
E02000442,1912,255,166,253,2586
E02000443,1455,248,207,347,2257
E02000444,1802,281,206,298,2587
E02000445,1602,290,238,390,2520
E02000447,1488,328,237,265,2318
E02000448,1351,373,269,487,2480
E02000449,1745,266,192,299,2502
E02000451,1364,322,237,325,2248
E02000452,1212,192,131,196,1731
E02000453,1364,241,163,246,2014
E02000454,1487,321,272,365,2445
E02000455,1494,254,233,349,2330
E02000456,1258,229,170,264,1921
E02000457,1393,259,238,335,2225
E02000459,1410,254,172,244,2080
E02000460,1209,167,105,154,1635
E02000461,1066,204,140,243,1653
E02000462,1164,204,167,251,1786
E02000463,1495,274,175,222,2166
E02006795,1535,272,207,284,2298
E02006882,3180,601,406,625,4812
E02000464,756,282,201,326,1565
E02000465,902,265,156,200,1523
E02000466,1004,368,265,375,2012
E02000467,1006,294,146,220,1666
E02000468,914,372,239,399,1924
E02000469,710,268,198,247,1423
E02000470,945,459,337,495,2236
E02000471,1010,452,367,529,2358
E02000472,1068,446,310,404,2228
E02000473,1157,430,322,496,2405
E02000474,976,310,221,421,1928
E02000475,1088,468,384,605,2545
E02000476,907,272,186,361,1726
E02000477,1179,503,344,499,2525
E02000478,1095,424,332,449,2300
E02000479,934,273,181,265,1653
E02000480,1667,324,242,387,2620
E02000481,1161,439,352,645,2597
E02000482,968,384,266,570,2188
E02000483,1086,407,310,520,2323
E02000484,1130,423,282,366,2201
E02000485,1072,367,307,460,2206
E02000486,1040,375,300,439,2154
E02000487,1099,579,396,598,2672
E02000488,1033,493,324,441,2291
E02000489,1063,328,288,382,2061
E02000490,909,389,280,458,2036
E02000491,1105,338,258,351,2052
E02000492,896,332,292,452,1972
E02000493,707,189,140,229,1265
E02000494,1852,462,339,594,3247
E02000495,1778,442,340,593,3153
E02000496,1771,371,270,377,2789
E02000497,1736,363,307,535,2941
E02000498,1167,365,232,348,2112
E02000499,1546,384,308,553,2791
E02000500,1520,446,332,550,2848
E02000501,1502,337,284,415,2538
E02000502,1389,291,215,463,2358
E02000503,1418,309,191,322,2240
E02000504,1344,377,309,461,2491
E02000506,1551,395,326,480,2752
E02000507,1421,257,169,272,2119
E02000508,1283,218,159,275,1935
E02000509,1031,211,141,200,1583
E02000510,1497,337,234,372,2440
E02000511,1380,296,237,388,2301
E02000512,1138,226,173,220,1757
E02000513,1146,180,116,175,1617
E02000514,1548,267,183,289,2287
E02000515,1508,298,205,289,2300
E02000516,1192,211,136,163,1702
E02000517,1318,257,180,256,2011
E02000518,1389,291,194,261,2135
E02000519,1254,268,164,276,1962
E02000520,1584,271,187,293,2335
E02000521,1872,234,151,241,2498
E02000522,1360,259,185,326,2130
E02000523,1377,214,178,234,2003
E02000524,1012,191,126,180,1509
E02000525,1354,220,136,207,1917
E02006796,1291,292,242,358,2183
E02000526,1091,321,229,278,1919
E02000528,1716,332,241,254,2543
E02000529,1730,264,172,243,2409
E02000530,1185,162,104,154,1605
E02000531,1541,318,229,324,2412
E02000532,1365,367,284,286,2302
E02000533,1325,325,217,248,2115
E02000534,1284,278,211,303,2076
E02000535,1779,304,237,310,2630
E02000536,1698,318,208,316,2540
E02000537,1430,291,236,345,2302
E02000538,1531,264,162,225,2182
E02000539,1673,283,198,273,2427
E02000540,1512,303,201,305,2321
E02000541,1459,270,197,304,2230
E02000542,1522,278,196,314,2310
E02000543,1538,272,179,252,2241
E02000544,1294,327,199,300,2120
E02000545,1117,287,169,235,1808
E02000546,1449,271,188,257,2165
E02000547,1704,309,220,322,2555
E02000548,1544,267,144,237,2192
E02000549,2129,378,247,398,3152
E02000550,1436,213,128,192,1969
E02000551,1418,232,169,182,2001
E02000552,1058,207,127,182,1574
E02000553,933,216,106,195,1450
E02006792,1068,250,234,350,1902
E02000554,1008,218,113,138,1477
E02000555,1002,217,174,207,1600
E02000556,1107,237,128,155,1627
E02000557,1033,187,189,212,1621
E02000558,799,198,120,186,1303
E02000559,997,170,118,154,1439
E02000560,702,124,98,129,1053
E02000561,999,230,168,142,1539
E02000562,814,215,146,180,1355
E02000563,959,192,120,164,1435
E02000564,1239,176,134,159,1708
E02000565,795,162,100,145,1202
E02000566,951,221,156,171,1499
E02000567,1091,240,152,193,1676
E02000568,1037,214,138,216,1605
E02000569,1180,242,164,264,1850
E02000570,900,267,146,193,1506
E02000571,1001,213,145,177,1536
E02000572,1017,168,121,169,1475
E02000573,940,258,185,209,1592
E02000574,916,191,107,194,1408
E02000575,1119,212,141,200,1672
E02000576,855,179,123,219,1376
E02000577,941,192,127,191,1451
E02000578,787,161,124,160,1232
E02000579,980,264,199,217,1660
E02000580,870,228,166,171,1435
E02000581,869,224,184,245,1522
E02000582,734,196,152,286,1368
E02000583,713,211,171,231,1326
E02000584,712,275,190,253,1430
E02000585,873,221,206,238,1538
E02000586,553,199,135,160,1047
E02000587,728,233,176,243,1380
E02000588,543,180,142,189,1054
E02000589,644,158,129,162,1093
E02000590,680,211,166,253,1310
E02000591,753,198,147,139,1237
E02000592,514,134,119,184,951
E02000593,743,199,156,160,1258
E02000594,718,276,258,422,1674
E02000595,694,237,198,255,1384
E02000596,766,177,139,207,1289
E02000597,948,243,159,224,1574
E02000598,1136,329,231,309,2005
E02000599,1165,344,259,472,2240
E02000600,1320,267,208,269,2064
E02000601,1315,297,221,260,2093
E02000602,1349,258,158,226,1991
E02000603,1233,255,167,204,1859
E02000604,1142,329,221,305,1997
E02000605,1085,323,258,389,2055
E02000606,1160,303,208,293,1964
E02000607,804,226,156,211,1397
E02000608,675,185,121,167,1148
E02000609,1112,377,253,370,2112
E02000610,880,257,166,320,1623
E02000611,1124,414,299,395,2232
E02000612,1250,469,325,464,2508
E02000613,894,281,199,317,1691
E02000614,1213,293,191,278,1975
E02000615,1126,323,242,319,2010
E02000616,918,264,166,217,1565
E02000617,1335,340,257,336,2268
E02000619,1223,208,118,182,1731
E02000620,1261,168,151,193,1773
E02000621,1387,187,133,195,1902
E02000622,1081,132,92,133,1438
E02000623,1029,164,126,172,1491
E02000624,1056,156,75,147,1434
E02000625,902,120,69,106,1197
E02000626,904,94,92,100,1190
E02000627,990,153,105,167,1415
E02000628,974,156,101,139,1370
E02000629,990,141,99,100,1330
E02000630,836,153,94,128,1211
E02000631,1209,205,132,169,1715
E02000632,929,109,68,114,1220
E02000633,854,118,103,125,1200
E02000634,802,120,86,129,1137
E02000635,1020,154,91,119,1384
E02000636,746,177,117,132,1172
E02000637,964,122,81,121,1288
E02000638,1165,138,120,185,1608
E02000639,995,123,70,111,1299
E02000640,1137,179,151,183,1650
E02000641,953,125,76,146,1300
E02000642,1203,254,162,218,1837
E02000643,1204,155,96,158,1613
E02000644,1067,188,91,152,1498
E02000645,1140,194,115,159,1608
E02000646,1299,204,145,225,1873
E02000647,1194,222,147,258,1821
E02000648,853,167,116,151,1287
E02000649,1425,183,122,192,1922
E02000650,966,160,89,118,1333
E02000651,1209,184,130,225,1748
E02000652,870,176,134,233,1413
E02006801,1274,211,124,189,1798
E02000653,1144,120,91,117,1472
E02000654,931,120,66,107,1224
E02000655,861,104,87,101,1153
E02000657,822,142,113,119,1196
E02000658,893,161,104,139,1297
E02000659,833,160,128,163,1284
E02000660,711,123,99,87,1020
E02000661,736,200,160,261,1357
E02000662,825,96,92,97,1110
E02000663,706,147,121,113,1087
E02000664,1296,174,138,226,1834
E02000665,870,204,133,201,1408
E02000666,777,140,118,177,1212
E02000667,712,155,109,162,1138
E02000668,834,177,150,172,1333
E02000669,1019,137,92,135,1383
E02000670,636,93,95,149,973
E02000671,1114,187,118,183,1602
E02000672,1086,149,102,202,1539
E02000673,918,176,127,146,1367
E02000674,885,192,162,258,1497
E02000675,1119,303,182,284,1888
E02000676,1056,157,98,188,1499
E02000677,823,195,125,228,1371
E02000678,737,119,103,146,1105
E02000679,969,192,142,190,1493
E02000680,776,140,95,181,1192
E02000681,1072,261,141,222,1696
E02000682,928,216,133,229,1506
E02000683,753,160,123,203,1239
E02000685,939,199,158,241,1537
E02000686,810,127,84,109,1130
E02000687,980,228,164,255,1627
E02006783,860,132,97,170,1259
E02006784,916,235,169,276,1596
E02006798,904,117,100,106,1227
E02000689,1256,222,155,167,1800
E02000690,1179,313,261,407,2160
E02000691,1109,190,123,222,1644
E02000692,1347,320,223,412,2302
E02000693,1383,200,112,201,1896
E02000694,1238,221,126,168,1753
E02000695,1356,219,204,257,2036
E02000696,1147,180,84,108,1519
E02000697,1147,196,99,170,1612
E02000698,1446,361,268,370,2445
E02000699,1156,228,165,267,1816
E02000700,1235,170,109,127,1641
E02000701,1404,235,162,239,2040
E02000702,1325,185,111,191,1812
E02000703,1351,365,257,378,2351
E02000704,1185,246,177,278,1886
E02000705,1342,240,199,298,2079
E02000706,1486,177,115,191,1969
E02000707,1207,186,122,197,1712
E02000708,1244,324,199,309,2076
E02000709,1416,335,242,405,2398
E02000710,1397,297,218,368,2280
E02000711,1282,199,137,242,1860
E02000712,1465,278,182,339,2264
E02000713,1414,353,210,346,2323
E02000714,900,114,92,114,1220
E02000715,615,103,83,119,920
E02000716,664,118,71,122,975
E02000717,722,130,87,110,1049
E02000718,601,99,70,99,869
E02000719,870,118,83,115,1186
E02000720,783,163,102,131,1179
E02000721,780,163,80,146,1169
E02000722,830,132,80,139,1181
E02000723,1003,176,145,219,1543
E02000724,793,130,109,140,1172
E02000725,1016,126,85,120,1347
E02000726,2465,119,88,99,2771
E02000727,791,130,68,130,1119
E02000728,758,146,95,116,1115
E02000729,660,145,77,143,1025
E02000730,955,193,119,180,1447
E02000731,864,195,105,170,1334
E02000732,777,120,90,133,1120
E02000733,887,190,108,127,1312
E02000734,644,127,81,131,983
E02000735,655,152,118,158,1083
E02000736,707,134,94,128,1063
E02000737,909,187,104,149,1349
E02000738,829,141,93,144,1207
E02000739,565,141,76,102,884
E02000740,580,111,67,84,842
E02000741,734,140,89,99,1062
E02000742,696,107,73,134,1010
E02000743,790,137,86,153,1166
E02000744,751,151,99,132,1133
E02000745,658,152,72,82,964
E02000746,820,125,49,87,1081
E02000747,894,169,126,116,1305
E02000748,498,107,69,80,754
E02000749,734,156,91,146,1127
E02000750,1280,125,95,100,1600
E02000751,1898,607,473,666,3644
E02000752,857,236,154,219,1466
E02000753,765,190,145,230,1330
E02000754,851,241,150,222,1464
E02000755,666,199,162,184,1211
E02000756,1726,463,341,424,2954
E02000757,1502,425,279,451,2657
E02000758,854,233,159,282,1528
E02000759,1546,333,237,362,2478
E02000760,976,233,179,300,1688
E02000762,919,257,169,299,1644
E02000763,848,204,158,220,1430
E02000764,1661,466,407,684,3218
E02000765,677,187,115,258,1237
E02000767,873,223,188,287,1571
E02000768,802,283,151,266,1502
E02000769,1387,289,198,487,2361
E02000770,967,215,147,206,1535
E02000772,838,139,109,156,1242
E02000773,977,208,145,203,1533
E02000774,760,184,121,166,1231
E02000776,711,162,119,162,1154
E02000777,986,291,159,206,1642
E02000779,870,152,105,194,1321
E02000780,1317,307,194,303,2121
E02000781,1532,386,286,428,2632
E02000782,764,147,94,189,1194
E02000783,485,113,82,125,805
E02006800,1361,290,172,231,2054
E02006924,1710,402,296,496,2904
E02006925,1995,498,347,526,3366
E02000784,1530,461,381,489,2861
E02000785,1041,440,348,511,2340
E02000786,1569,479,316,373,2737
E02000787,1184,424,270,388,2266
E02000788,1121,378,253,335,2087
E02000789,559,263,189,283,1294
E02000790,594,193,151,159,1097
E02000791,488,273,205,262,1228
E02000792,608,291,248,341,1488
E02000793,1013,330,257,362,1962
E02000794,763,238,177,249,1427
E02000795,812,336,297,383,1828
E02000796,1583,432,306,449,2770
E02000797,677,237,145,197,1256
E02000798,1197,357,222,339,2115
E02000799,670,253,171,232,1326
E02000800,611,210,173,191,1185
E02000801,827,291,203,203,1524
E02000802,902,337,234,337,1810
E02000803,1479,465,277,448,2669
E02000804,849,333,230,320,1732
E02000805,1427,455,298,421,2601
E02000806,1589,510,365,486,2950
E02000807,1030,158,98,101,1387
E02000808,1209,172,95,144,1620
E02000809,1174,153,77,80,1484
E02000810,1274,227,125,152,1778
E02000812,1307,173,113,214,1807
E02000813,1052,166,96,136,1450
E02000814,1075,149,87,116,1427
E02000815,830,57,57,60,1004
E02000816,995,167,107,170,1439
E02000817,819,161,90,218,1288
E02000818,1061,165,122,156,1504
E02000819,1011,137,95,130,1373
E02000820,1075,137,112,146,1470
E02000821,799,125,90,114,1128
E02000822,724,138,61,98,1021
E02000823,933,158,117,153,1361
E02000824,892,150,106,140,1288
E02000825,908,122,85,118,1233
E02000826,911,141,99,126,1277
E02000827,1184,207,105,161,1657
E02000828,810,140,75,114,1139
E02000829,932,192,133,225,1482
E02000830,913,175,138,163,1389
E02000831,901,179,105,162,1347
E02000832,984,210,122,187,1503
E02000833,1004,122,91,120,1337
E02000834,1084,212,124,168,1588
E02000835,877,137,87,135,1236
E02000836,1031,179,145,178,1533
E02000837,1350,311,202,335,2198
E02000838,1156,230,140,193,1719
E02000839,1185,250,218,264,1917
E02006802,1022,130,89,122,1363
E02000840,1196,185,126,200,1707
E02000841,1335,179,146,197,1857
E02000842,1489,367,225,365,2446
E02000843,1099,232,140,246,1717
E02000844,1146,281,159,266,1852
E02000845,1064,273,197,289,1823
E02000846,1128,294,236,343,2001
E02000847,1321,491,383,499,2694
E02000848,1102,305,248,331,1986
E02000849,1123,309,229,295,1956
E02000850,1460,445,285,391,2581
E02000851,1295,254,220,333,2102
E02000852,1140,270,194,340,1944
E02000853,1049,270,168,269,1756
E02000854,1140,280,203,303,1926
E02000855,1106,397,299,451,2253
E02000856,1224,372,247,346,2189
E02000857,1087,269,222,490,2068
E02000858,943,227,179,203,1552
E02000859,1200,421,292,584,2497
E02000860,1106,277,167,318,1868
E02000861,1219,461,362,419,2461
E02000863,1095,377,231,309,2012
E02006836,1396,504,394,577,2871
E02000864,908,181,104,182,1375
E02000865,736,120,81,124,1061
E02000866,976,197,136,168,1477
E02000867,925,122,89,122,1258
E02000868,675,94,65,110,944
E02000869,525,120,75,115,835
E02000870,611,114,64,113,902
E02000871,861,108,76,138,1183
E02000872,630,72,48,92,842
E02000873,634,87,57,114,892
E02000874,631,64,56,90,841
E02000875,964,130,78,116,1288
E02000876,702,88,52,82,924
E02000877,972,110,98,140,1320
E02000878,1024,95,88,126,1333
E02000879,925,183,112,235,1455
E02000880,739,65,35,101,940
E02000881,783,126,78,107,1094
E02000882,1039,131,87,161,1418
E02000883,745,131,79,131,1086
E02000884,1019,81,67,88,1255
E02000885,825,134,104,155,1218
E02000886,648,111,59,92,910
E02000887,782,149,87,148,1166
E02000888,752,87,50,88,977
E02000889,765,89,60,92,1006
E02000890,543,133,65,86,827
E02000891,1118,127,94,95,1434
E02000893,626,147,88,141,1002
E02000894,722,140,85,95,1042
E02006853,605,87,59,84,835
E02006854,404,56,21,35,516
E02000895,1107,385,319,521,2332
E02000896,1353,401,298,507,2559
E02000897,1172,282,235,426,2115
E02000898,1160,313,250,383,2106
E02000899,1156,290,231,388,2065
E02000900,1038,269,208,257,1772
E02000901,1634,362,252,317,2565
E02000902,1071,228,161,217,1677
E02000903,871,172,130,152,1325
E02000904,781,173,121,153,1228
E02000905,946,186,105,152,1389
E02000906,857,142,106,142,1247
E02000907,773,180,118,210,1281
E02000908,998,168,110,153,1429
E02000909,988,196,104,167,1455
E02000910,1070,208,129,223,1630
E02000911,1135,181,121,148,1585
E02000912,903,186,138,147,1374
E02000913,1242,201,177,179,1799
E02000914,1192,176,124,214,1706
E02000915,1349,189,122,163,1823
E02000916,900,145,108,141,1294
E02000917,1022,141,93,129,1385
E02000918,1144,191,121,132,1588
E02000919,1083,168,112,179,1542
E02000920,1134,178,120,168,1600
E02000921,910,226,140,136,1412
E02000922,922,172,127,178,1399
E02000923,700,234,215,347,1496
E02000924,1327,199,150,201,1877
E02000925,765,164,107,154,1190
E02000926,1123,266,162,196,1747
E02000927,774,190,136,156,1256
E02000928,1248,309,210,220,1987
E02000929,751,147,116,148,1162
E02000930,892,163,104,151,1310
E02000931,735,143,105,119,1102
E02000932,1424,214,159,194,1991
E02000933,1409,349,209,310,2277
E02000934,915,189,117,159,1380
E02000935,765,133,125,199,1222
E02000936,1288,229,188,283,1988
E02000937,802,173,97,109,1181
E02000938,1476,317,217,408,2418
E02000939,786,205,151,266,1408
E02000940,1035,152,112,136,1435
E02000941,1167,258,154,190,1769
E02000942,1278,311,222,254,2065
E02000943,1050,168,126,172,1516
E02000944,1169,162,101,184,1616
E02000945,1086,169,121,163,1539
E02000946,819,168,75,142,1204
E02000947,1136,196,145,173,1650
E02000948,1264,188,127,219,1798
E02000949,1440,270,175,253,2138
E02000950,1111,212,150,210,1683
E02000951,912,138,87,127,1264
E02000952,945,152,98,119,1314
E02000953,1129,104,97,114,1444
E02000954,941,165,109,191,1406
E02000955,997,171,110,185,1463
E02000956,1174,132,72,118,1496
E02000957,1635,212,127,240,2214
E02000958,1357,233,151,258,1999
E02000959,989,147,95,145,1376
E02000960,967,207,173,334,1681
E02000961,1136,216,180,271,1803
E02000962,1038,289,243,349,1919
E02000963,1245,230,200,213,1888
E02000964,1361,224,192,219,1996
E02000965,884,150,119,157,1310
E02000966,1160,224,171,216,1771
E02000967,652,145,142,210,1149
E02000968,1687,317,240,394,2638
E02000969,1215,170,132,242,1759
E02000970,916,211,166,215,1508
E02000971,784,163,159,173,1279
E02000972,1098,162,121,152,1533
E02000973,935,261,178,213,1587
E02000974,956,227,159,204,1546
E02000975,665,152,99,106,1022
E02000976,789,183,159,186,1317
E02000977,766,160,106,152,1184
E02000978,630,195,151,256,1232
E02000979,984,253,169,225,1631
E02000980,1028,249,198,240,1715
E02000981,934,199,141,146,1420
E02000982,903,224,181,212,1520
E02000983,905,215,172,283,1575
E02002483,1406,480,303,493,2682
E02002484,1382,480,283,457,2602
E02002485,1078,368,264,284,1994
E02002487,567,174,119,141,1001
E02002488,874,344,263,394,1875
E02002489,820,288,183,280,1571
E02002490,714,246,153,183,1296
E02002491,795,270,196,426,1687
E02002492,912,372,225,336,1845
E02002493,961,450,321,441,2173
E02002494,973,295,213,301,1782
E02006909,1855,863,617,834,4169
E02002496,1067,201,127,197,1592
E02002497,732,187,115,150,1184
E02002498,746,157,121,172,1196
E02002499,1130,223,133,232,1718
E02002500,884,220,131,213,1448
E02002501,1005,180,150,160,1495
E02002502,1563,376,248,390,2577
E02002503,998,207,131,192,1528
E02002504,1465,387,255,366,2473
E02002505,959,199,105,171,1434
E02002506,1052,204,134,220,1610
E02002507,1049,292,250,336,1927
E02002508,855,279,271,386,1791
E02002509,966,253,156,271,1646
E02002510,1190,478,364,429,2461
E02002512,929,354,253,373,1909
E02002513,1576,540,335,481,2932
E02002514,1498,460,271,432,2661
E02006811,1945,673,529,663,3810
E02002515,767,283,193,381,1624
E02002516,749,274,206,292,1521
E02002517,597,268,193,279,1337
E02002518,1480,634,459,607,3180
E02002519,903,430,356,487,2176
E02002520,1728,928,783,955,4394
E02002521,785,448,352,563,2148
E02002523,702,185,112,138,1137
E02002524,740,375,264,285,1664
E02002525,1190,441,383,492,2506
E02002526,1073,476,290,318,2157
E02002527,635,252,180,200,1267
E02002529,823,378,264,274,1739
E02002530,777,442,314,346,1879
E02002532,929,375,270,413,1987
E02002533,889,486,357,418,2150
E02002534,707,543,409,496,2155
E02006812,1225,428,336,520,2509
E02006910,1456,502,370,522,2850
E02002535,1709,589,360,450,3108
E02002536,1510,465,366,551,2892
E02002537,1175,308,220,395,2098
E02002538,962,306,216,250,1734
E02002539,1618,657,496,529,3300
E02002540,1004,546,354,455,2359
E02002541,985,335,218,356,1894
E02002542,1271,351,202,292,2116
E02002543,1459,315,170,302,2246
E02002544,1173,319,206,328,2026
E02002545,863,394,251,327,1835
E02002546,1002,248,170,247,1667
E02002547,951,484,340,489,2264
E02002548,1509,316,196,257,2278
E02002549,1182,543,495,613,2833
E02002550,908,286,236,358,1788
E02002551,593,184,125,193,1095
E02002552,876,342,185,208,1611
E02002553,716,317,210,303,1546
E02002554,636,317,231,302,1486
E02002555,1417,625,451,649,3142
E02002556,1139,398,239,239,2015
E02002557,2228,361,197,259,3045
E02002558,1662,744,526,631,3563
E02002559,1304,548,395,391,2638
E02002560,828,309,226,278,1641
E02002561,808,433,247,297,1785
E02002562,614,222,176,264,1276
E02002563,794,360,228,385,1767
E02002564,1341,446,339,475,2601
E02002565,694,229,146,186,1255
E02002566,658,219,139,209,1225
E02002567,1012,399,270,399,2080
E02002568,890,383,270,503,2046
E02002569,1292,664,586,977,3519
E02002570,958,379,226,416,1979
E02002571,637,242,204,281,1364
E02002572,696,239,154,181,1270
E02002573,1263,570,440,595,2868
E02004290,902,372,286,334,1894
E02004291,1089,352,250,338,2029
E02004292,1191,537,501,682,2911
E02004293,1492,420,372,540,2824
E02004294,1287,575,409,517,2788
E02004295,1145,492,333,427,2397
E02004296,1206,458,304,366,2334
E02004297,1263,459,377,471,2570
E02004298,1652,622,419,626,3319
E02004299,1327,483,348,443,2601
E02004300,1155,482,341,392,2370
E02004301,1426,422,296,333,2477
E02004302,1110,403,313,329,2155
E02004303,1663,597,431,620,3311
E02004304,1308,417,322,506,2553
E02004305,1370,425,320,424,2539
E02004306,946,442,338,408,2134
E02004307,1138,355,243,309,2045
E02004308,1328,606,404,421,2759
E02004309,1038,352,236,403,2029
E02004310,1137,467,343,337,2284
E02004311,1353,559,369,451,2732
E02004312,1187,638,494,636,2955
E02004313,856,259,190,252,1557
E02004314,684,178,126,291,1279
E02004315,1664,469,325,454,2912
E02004316,982,322,228,268,1800
E02004317,1127,484,318,412,2341
E02004318,1021,350,273,341,1985
E02004319,1156,383,315,380,2234
E02004320,1401,470,315,484,2670
E02004321,1305,356,291,471,2423
E02004322,1348,471,319,429,2567
E02004323,1131,334,253,332,2050
E02004324,701,326,236,275,1538
E02004325,1152,352,227,371,2102
E02004326,1009,319,235,305,1868
E02004327,821,305,276,353,1755
E02004328,892,311,268,373,1844
E02004329,990,381,300,359,2030
E02004330,836,365,303,407,1911
E02004331,1111,400,319,352,2182
E02004332,1239,343,253,321,2156
E02004333,1054,531,369,373,2327
E02004334,1203,374,292,293,2162
E02004335,1077,344,246,308,1975
E02004336,1059,410,346,442,2257
E02004337,1552,594,323,452,2921
E02004338,1162,402,265,308,2137
E02004339,1112,519,419,445,2495
E02004340,1492,606,355,535,2988
E02004341,1338,570,392,390,2690
E02004342,581,217,151,223,1172
E02004343,792,306,227,381,1706
E02004344,1000,448,312,463,2223
E02004345,2391,947,659,823,4820
E02004346,940,433,293,299,1965
E02004347,1315,507,383,643,2848
E02004348,1062,664,478,550,2754
E02004349,1251,462,344,444,2501
E02004350,1325,616,437,521,2899
E02004351,1103,400,271,331,2105
E02004352,1136,420,283,421,2260
E02004353,1198,495,334,534,2561
E02004354,1373,566,340,362,2641
E02004355,1128,384,237,304,2053
E02005702,836,549,395,590,2370
E02005703,928,477,330,476,2211
E02005704,2054,981,713,858,4606
E02005705,1052,651,483,545,2731
E02005706,753,597,397,652,2399
E02005707,508,601,463,517,2089
E02005708,904,860,664,779,3207
E02005709,1054,322,212,274,1862
E02005710,1605,499,335,480,2919
E02005711,1351,481,329,363,2524
E02005712,1434,405,244,269,2352
E02005713,1194,527,314,264,2299
E02005714,819,346,181,135,1481
E02005715,1367,483,349,488,2687
E02005716,1617,609,312,338,2876
E02005717,1071,583,457,541,2652
E02005718,1089,690,470,408,2657
E02005719,1193,479,341,360,2373
E02005720,1933,793,531,569,3826
E02005721,863,328,205,336,1732
E02005722,1389,581,378,459,2807
E02005723,896,387,315,587,2185
E02005724,974,565,385,581,2505
E02005725,810,541,392,748,2491
E02005726,1078,561,420,656,2715
E02005727,650,431,316,394,1791
E02005728,849,534,390,439,2212
E02005729,766,408,303,388,1865
E02005730,1746,930,719,1065,4460
E02005731,1553,643,435,528,3159
E02005732,1243,728,585,816,3372
E02005733,977,644,444,519,2584
E02005734,885,393,262,379,1919
E02005735,1006,316,226,302,1850
E02005736,1202,473,318,303,2296
E02005737,1208,439,324,375,2346
E02005738,776,340,234,240,1590
E02005739,1459,553,464,632,3108
E02005740,1504,552,383,500,2939
E02005741,1308,546,374,556,2784
E02001708,2254,623,352,525,3754
E02001709,1861,590,425,630,3506
E02001710,1341,423,293,513,2570
E02001711,1339,421,291,516,2567
E02001712,1732,462,296,534,3024
E02001713,2000,488,360,549,3397
E02001714,1774,479,245,435,2933
E02001715,1624,441,255,411,2731
E02001718,913,292,206,258,1669
E02001719,1423,414,285,438,2560
E02001720,1377,220,144,196,1937
E02001721,1599,594,392,632,3217
E02001722,1326,410,336,662,2734
E02001723,920,198,157,259,1534
E02001724,1122,216,170,296,1804
E02001725,1168,205,132,184,1689
E02001726,1464,431,290,424,2609
E02001727,1282,418,300,442,2442
E02001728,1427,533,360,414,2734
E02001729,946,167,104,233,1450
E02001730,1255,205,128,162,1750
E02001731,1229,226,125,219,1799
E02001732,746,244,134,179,1303
E02001733,1429,429,303,428,2589
E02001734,970,319,235,348,1872
E02001735,779,211,154,262,1406
E02001736,1132,293,177,263,1865
E02001737,767,253,169,261,1450
E02006893,1702,839,646,891,4078
E02001738,873,509,410,584,2376
E02001739,1139,501,314,354,2308
E02001740,816,345,246,380,1787
E02001741,1230,574,382,623,2809
E02001742,876,417,308,400,2001
E02001743,1131,374,230,322,2057
E02001744,1128,348,222,380,2078
E02001745,989,359,221,258,1827
E02001746,1103,452,302,466,2323
E02001747,921,438,338,604,2301
E02001748,1065,349,185,290,1889
E02001749,910,446,230,366,1952
E02001750,1041,413,300,531,2285
E02001751,974,319,241,358,1892
E02001752,853,283,199,304,1639
E02001753,868,404,261,380,1913
E02001754,850,350,266,408,1874
E02001755,1444,450,326,486,2706
E02001756,1370,354,255,381,2360
E02001757,882,362,238,387,1869
E02001758,879,368,217,173,1637
E02001759,852,293,207,333,1685
E02001760,866,252,191,239,1548
E02001761,936,330,269,352,1887
E02001762,1171,331,217,214,1933
E02001763,1010,315,205,251,1781
E02001764,945,331,188,288,1752
E02001765,1055,282,216,300,1853
E02001766,996,253,159,192,1600
E02001767,1149,318,257,315,2039
E02001768,1433,376,279,299,2387
E02001769,1312,335,201,262,2110
E02001770,1104,309,231,335,1979
E02001771,1140,347,270,410,2167
E02001772,935,284,230,358,1807
E02001773,1069,406,282,417,2174
E02001774,889,294,197,212,1592
E02001775,988,320,199,332,1839
E02001776,1421,369,211,406,2407
E02001777,1033,321,192,279,1825
E02001778,1078,287,177,289,1831
E02001779,1002,300,189,260,1751
E02001780,1060,375,274,322,2031
E02001781,946,232,126,215,1519
E02001782,1535,445,312,525,2817
E02001783,1213,278,160,247,1898
E02001784,1094,320,273,353,2040
E02001785,1356,526,372,484,2738
E02001786,1345,330,216,380,2271
E02001787,963,418,254,266,1901
E02001788,1061,328,170,273,1832
E02001789,1046,426,305,477,2254
E02001790,1066,357,245,433,2101
E02001791,871,317,253,423,1864
E02001792,1184,451,337,606,2578
E02001793,1186,290,194,359,2029
E02001794,1297,382,320,505,2504
E02001795,1150,412,253,367,2182
E02001796,1297,547,355,560,2759
E02001797,754,424,274,330,1782
E02001798,1298,374,272,350,2294
E02001799,872,421,251,405,1949
E02001800,830,481,240,252,1803
E02001801,983,210,99,166,1458
E02001802,1126,287,192,295,1900
E02001803,1057,269,164,261,1751
E02001804,1232,322,253,349,2156
E02001805,1019,315,248,460,2042
E02001806,1051,365,221,300,1937
E02001807,899,426,258,318,1901
E02001808,927,211,164,248,1550
E02001809,819,546,325,343,2033
E02001810,1034,562,273,254,2123
E02001811,1267,465,332,434,2498
E02001812,1707,697,510,790,3704
E02001813,1231,403,292,371,2297
E02001814,1032,308,192,336,1868
E02001815,1461,759,464,471,3155
E02001816,1181,416,267,444,2308
E02001817,1308,307,259,382,2256
E02001818,1824,360,253,422,2859
E02001819,1259,545,397,549,2750
E02001820,1305,470,313,456,2544
E02001821,1203,316,184,261,1964
E02001822,1053,407,268,357,2085
E02001823,1049,371,238,315,1973
E02001824,1097,521,429,595,2642
E02001825,1083,470,396,533,2482
E02001826,1004,379,263,258,1904
E02001682,1088,499,348,509,2444
E02001683,1205,562,427,533,2727
E02001684,852,295,174,308,1629
E02001685,939,352,259,378,1928
E02001686,893,387,362,481,2123
E02001688,938,266,167,228,1599
E02001689,828,293,181,332,1634
E02001690,956,393,240,398,1987
E02001691,994,244,149,214,1601
E02001692,825,233,126,188,1372
E02001693,828,293,193,313,1627
E02001694,885,331,237,323,1776
E02001695,849,354,251,332,1786
E02001696,1343,480,274,486,2583
E02001697,1319,426,287,461,2493
E02001698,925,666,469,736,2796
E02001699,1097,342,258,412,2109
E02001700,1455,655,415,531,3056
E02001701,980,434,329,499,2242
E02001702,1049,338,217,367,1971
E02001703,769,403,303,426,1901
E02001704,984,299,283,502,2068
E02001705,1072,423,280,349,2124
E02001706,916,372,250,348,1886
E02001707,1022,487,388,583,2480
E02006841,869,234,130,184,1417
E02006842,618,206,154,289,1267
E02002574,1421,492,363,399,2675
E02002575,1678,483,284,360,2805
E02002576,1254,401,249,359,2263
E02002577,1079,339,230,349,1997
E02002578,1286,351,235,328,2200
E02002579,1217,366,239,330,2152
E02002580,1084,249,181,261,1775
E02002581,1139,495,345,458,2437
E02002582,1422,455,224,234,2335
E02002583,1058,372,223,206,1859
E02002584,1091,387,243,348,2069
E02002585,1484,455,310,339,2588
E02002586,1360,439,258,341,2398
E02002587,1057,372,178,147,1754
E02002588,1124,432,218,257,2031
E02002589,1122,586,335,363,2406
E02002590,929,341,345,457,2072
E02002591,960,383,325,460,2128
E02002592,960,366,345,437,2108
E02002593,762,294,224,235,1515
E02002594,685,293,148,123,1249
E02002595,1120,208,145,222,1695
E02002596,1346,606,383,365,2700
E02002597,1351,376,274,274,2275
E02002598,1610,316,158,191,2275
E02002599,1956,501,325,359,3141
E02002600,1368,345,307,410,2430
E02002601,1347,473,414,508,2742
E02002602,1229,224,132,139,1724
E02002603,1048,536,339,373,2296
E02002604,1323,474,420,488,2705
E02002605,1612,490,285,343,2730
E02002606,1436,329,225,396,2386
E02002607,1473,464,391,509,2837
E02002608,1353,555,551,818,3277
E02002609,1330,287,182,309,2108
E02002610,1859,668,606,786,3919
E02002611,1150,406,341,591,2488
E02002612,1345,491,395,615,2846
E02002613,1059,377,301,346,2083
E02002614,993,438,328,447,2206
E02002615,1258,453,338,543,2592
E02002616,1149,306,240,330,2025
E02002617,864,190,120,157,1331
E02002618,787,164,86,150,1187
E02002619,852,210,156,250,1468
E02002620,889,217,137,197,1440
E02002621,630,179,88,124,1021
E02002622,964,278,170,234,1646
E02002623,1252,354,223,305,2134
E02002624,1444,518,427,594,2983
E02002625,1332,337,201,247,2117
E02002626,1090,387,254,379,2110
E02002627,1145,271,184,174,1774
E02002628,1060,355,239,298,1952
E02002629,793,192,156,197,1338
E02002630,902,247,165,302,1616
E02002631,1426,580,327,362,2695
E02002632,1200,427,311,293,2231
E02002633,1462,570,479,677,3188
E02002634,1609,579,443,649,3280
E02002635,1499,576,434,648,3157
E02002636,1530,418,312,379,2639
E02002637,1156,300,288,344,2088
E02002638,979,293,195,264,1731
E02002639,975,216,136,162,1489
E02002640,1038,219,139,183,1579
E02002641,1732,370,263,392,2757
E02002642,1103,252,198,234,1787
E02002643,1353,277,184,234,2048
E02002644,1623,374,285,419,2701
E02002645,951,249,153,145,1498
E02002646,1274,453,286,409,2422
E02002647,1428,345,242,304,2319
E02002648,1324,353,254,298,2229
E02002649,1577,433,367,539,2916
E02002650,1644,565,436,587,3232
E02002651,1511,474,429,607,3021
E02003811,937,490,408,458,2293
E02003812,715,486,373,522,2096
E02003813,882,404,320,413,2019
E02003814,1112,359,224,243,1938
E02003815,1076,351,269,380,2076
E02003816,1075,453,350,412,2290
E02003817,1148,583,408,541,2680
E02003818,932,466,355,441,2194
E02003819,891,531,421,521,2364
E02003820,1150,358,266,308,2082
E02003821,804,372,317,429,1922
E02003822,1627,868,635,700,3830
E02003823,929,507,437,594,2467
E02003824,893,402,287,353,1935
E02003825,992,253,138,131,1514
E02003826,1060,321,233,271,1885
E02003827,1000,340,300,368,2008
E02003828,713,284,187,249,1433
E02003829,792,386,329,391,1898
E02003830,889,229,170,297,1585
E02003831,1402,641,474,560,3077
E02003832,534,172,107,155,968
E02003833,830,288,250,290,1658
E02003834,669,212,142,219,1242
E02003835,1111,596,514,711,2932
E02003836,866,514,354,706,2440
E02003837,1741,765,504,547,3557
E02003838,980,496,367,416,2259
E02003839,821,500,417,629,2367
E02003840,1505,810,560,815,3690
E02003853,973,445,322,403,2143
E02003854,962,488,356,455,2261
E02003855,955,559,471,655,2640
E02003856,1705,544,409,602,3260
E02003857,998,388,191,266,1843
E02003858,1088,427,299,574,2388
E02003859,1698,827,632,906,4063
E02003860,999,424,295,500,2218
E02003861,788,325,307,455,1875
E02003862,795,389,378,526,2088
E02003863,837,437,352,577,2203
E02003864,1181,559,407,744,2891
E02003865,1207,492,357,443,2499
E02003866,944,403,304,392,2043
E02003867,1423,382,300,392,2497
E02003868,1318,440,296,448,2502
E02003869,1227,438,360,505,2530
E02003870,1694,423,290,448,2855
E02003871,1241,401,285,364,2291
E02003872,1606,741,602,776,3725
E02003873,995,257,156,241,1649
E02003794,1067,598,414,407,2486
E02003795,871,397,296,439,2003
E02003796,1103,394,346,634,2477
E02003797,1485,495,352,636,2968
E02003798,961,260,199,219,1639
E02003799,1125,310,245,362,2042
E02003800,952,506,429,522,2409
E02003801,967,368,266,428,2029
E02003802,1066,329,239,389,2023
E02003803,877,294,221,366,1758
E02003804,828,296,216,365,1705
E02003805,896,419,366,480,2161
E02003806,983,367,292,498,2140
E02003807,937,582,515,612,2646
E02003808,730,255,153,178,1316
E02003809,1060,508,386,584,2538
E02003810,1244,641,452,621,2958
E02003841,1114,605,458,619,2796
E02003842,807,490,368,498,2163
E02003843,957,333,233,403,1926
E02003844,907,538,381,505,2331
E02003845,1267,274,191,305,2037
E02003846,853,224,180,289,1546
E02003847,1503,547,382,458,2890
E02003848,684,213,164,280,1341
E02003849,1008,280,222,235,1745
E02003850,787,346,217,297,1647
E02003851,830,378,250,342,1800
E02003852,998,418,316,429,2161
E02003874,1242,623,479,693,3037
E02003875,808,527,398,419,2152
E02003876,628,375,241,222,1466
E02003877,1226,695,529,693,3143
E02003878,1089,594,383,551,2617
E02003879,876,275,190,352,1693
E02003880,779,416,308,363,1866
E02003881,749,303,171,180,1403
E02003882,1100,452,294,413,2259
E02003883,1230,588,417,564,2799
E02003884,1010,646,481,648,2785
E02003885,754,438,295,360,1847
E02003886,885,269,192,283,1629
E02003887,974,338,253,227,1792
E02003888,926,288,205,306,1725
E02003889,825,231,252,276,1584
E02003890,1040,309,256,232,1837
E02003891,915,505,372,478,2270
E02003965,1247,797,598,825,3467
E02003966,765,599,373,479,2216
E02003967,805,580,370,500,2255
E02003968,1095,583,449,525,2652
E02003969,821,363,246,336,1766
E02003970,921,572,364,530,2387
E02003971,918,614,398,595,2525
E02003972,1408,549,359,527,2843
E02003973,1300,417,277,361,2355
E02003974,1221,452,341,438,2452
E02003975,1105,463,338,481,2387
E02003976,558,464,348,615,1985
E02003977,897,359,251,319,1826
E02003978,890,319,260,389,1858
E02003979,1280,631,506,729,3146
E02003980,1051,318,215,244,1828
E02003981,1052,325,238,318,1933
E02003982,1285,499,391,424,2599
E02003983,1240,338,212,263,2053
E02003984,934,268,181,229,1612
E02003985,1089,463,354,386,2292
E02003986,1031,386,297,294,2008
E02003987,432,335,216,319,1302
E02003988,584,419,312,476,1791
E02003989,1103,492,392,562,2549
E02003990,1519,654,442,729,3344
E02003991,1174,537,420,502,2633
E02003992,991,331,235,348,1905
E02003993,839,646,477,600,2562
E02003994,1028,322,214,435,1999
E02003995,1353,467,342,535,2697
E02003996,1223,348,198,274,2043
E02003997,1155,391,258,358,2162
E02003998,836,286,231,313,1666
E02003999,1664,743,558,679,3644
E02004000,783,334,219,299,1635
E02004001,675,305,215,290,1485
E02004002,1372,575,417,545,2909
E02004003,1583,680,473,558,3294
E02004004,1252,470,290,457,2469
E02004005,1019,451,361,406,2237
E02004006,1060,601,459,610,2730
E02004007,1032,688,501,612,2833
E02004008,631,504,299,334,1768
E02004009,597,406,303,389,1695
E02004010,643,358,269,480,1750
E02004011,1116,764,578,850,3308
E02004012,513,418,302,407,1640
E02004013,953,719,518,679,2869
E02004014,615,571,441,550,2177
E02004015,859,366,360,536,2121
E02004016,1134,500,427,510,2571
E02004017,1340,534,353,574,2801
E02004018,1263,418,266,392,2339
E02004019,1214,629,447,620,2910
E02004020,1385,593,401,636,3015
E02004021,891,458,361,385,2095
E02004022,767,465,304,347,1883
E02004023,719,496,357,524,2096
E02004024,1130,611,486,637,2864
E02004025,1218,690,532,737,3177
E02004026,1127,474,331,448,2380
E02004027,1439,757,631,943,3770
E02004028,1152,641,495,643,2931
E02005176,1309,492,387,385,2573
E02005177,680,280,183,352,1495
E02005178,547,174,117,160,998
E02005179,1164,430,302,384,2280
E02005180,1023,442,298,413,2176
E02005181,845,270,214,240,1569
E02005182,623,270,196,250,1339
E02005183,857,371,271,345,1844
E02005184,777,437,314,294,1822
E02005185,958,319,204,247,1728
E02005186,834,347,210,251,1642
E02006881,1390,525,396,438,2749
E02005189,695,247,188,237,1367
E02005190,906,439,304,344,1993
E02005191,1492,589,391,416,2888
E02005192,1331,389,264,305,2289
E02005193,1345,621,442,455,2863
E02005194,1285,414,353,448,2500
E02005195,1030,462,302,382,2176
E02005196,1683,633,440,588,3344
E02005197,1039,307,232,256,1834
E02005198,1373,461,349,419,2602
E02005199,1109,580,445,473,2607
E02005200,1296,322,188,261,2067
E02005201,1336,438,357,403,2534
E02005202,1351,641,488,572,3052
E02005203,1736,589,468,489,3282
E02005204,1828,750,494,592,3664
E02005205,868,443,329,320,1960
E02005206,1223,472,360,476,2531
E02005207,1419,707,552,785,3463
E02005208,1527,692,547,1019,3785
E02005209,1231,611,490,557,2889
E02005210,1628,835,697,1214,4374
E02005211,1223,641,578,800,3242
E02005212,1398,584,439,579,3000
E02005213,1586,604,373,471,3034
E02005214,932,361,286,293,1872
E02005215,1355,549,416,537,2857
E02005216,620,252,182,182,1236
E02005217,817,273,215,281,1586
E02005218,917,388,295,377,1977
E02005219,1077,484,325,370,2256
E02005220,905,430,321,372,2028
E02005221,1754,775,539,723,3791
E02005222,943,518,381,474,2316
E02005223,1436,621,466,647,3170
E02005224,906,436,418,754,2514
E02005225,1116,415,300,412,2243
E02005226,1160,319,250,379,2108
E02005228,1039,302,174,277,1792
E02005229,856,207,149,174,1386
E02005230,1158,448,360,424,2390
E02005231,1394,332,193,259,2178
E02005233,1428,273,175,194,2070
E02005234,984,210,137,208,1539
E02005235,688,122,82,130,1022
E02005236,2425,825,651,726,4627
E02005237,1750,456,306,447,2959
E02005238,1027,272,179,331,1809
E02005239,1337,426,277,385,2425
E02006871,2266,676,553,749,4244
E02005240,606,292,218,308,1424
E02005241,615,348,204,253,1420
E02005242,612,407,264,311,1594
E02005243,588,309,176,263,1336
E02005244,636,278,156,272,1342
E02005245,898,441,329,328,1996
E02005246,560,230,160,216,1166
E02005247,1302,741,530,620,3193
E02005248,529,186,135,184,1034
E02005249,737,271,201,256,1465
E02005250,552,178,102,198,1030
E02005251,765,364,253,344,1726
E02005252,909,430,329,394,2062
E02005253,1106,435,294,392,2227
E02005254,1640,478,350,436,2904
E02005255,1785,513,420,627,3345
E02005256,1349,282,233,397,2261
E02005257,889,303,190,297,1679
E02005258,1525,433,356,590,2904
E02005259,1434,402,276,468,2580
E02005260,1080,375,304,452,2211
E02005261,1195,319,186,255,1955
E02005262,1107,259,171,210,1747
E02005263,756,132,93,147,1128
E02005264,1458,258,185,216,2117
E02005265,1617,408,311,459,2795
E02005266,745,165,103,147,1160
E02005267,562,100,63,100,825
E02005268,958,222,163,242,1585
E02005269,1044,211,120,192,1567
E02005270,1017,516,413,478,2424
E02005271,1059,467,347,560,2433
E02005272,1265,526,328,518,2637
E02005273,842,359,306,377,1884
E02005274,1075,519,375,438,2407
E02005275,850,359,263,342,1814
E02005276,1435,531,393,511,2870
E02005277,1478,609,537,677,3301
E02005278,1103,447,247,295,2092
E02005279,1087,453,299,399,2238
E02005280,1282,510,317,339,2448
E02005281,1004,397,278,362,2041
E02005284,859,419,298,393,1969
E02005285,968,438,295,347,2048
E02005286,1255,409,308,364,2336
E02006884,1429,637,448,500,3014
E02005287,741,325,234,359,1659
E02005288,856,388,333,346,1923
E02005289,862,455,321,406,2044
E02005290,975,375,240,310,1900
E02005291,751,323,218,283,1575
E02005292,657,334,194,298,1483
E02005293,649,306,232,391,1578
E02005294,857,306,224,292,1679
E02005295,1001,382,292,379,2054
E02005296,797,474,336,451,2058
E02005297,999,616,484,642,2741
E02005298,1114,452,286,351,2203
E02005299,1101,305,221,259,1886
E02005300,841,309,183,173,1506
E02005301,947,334,269,375,1925
E02005302,1172,459,315,393,2339
E02005303,920,311,216,291,1738
E02005304,1185,654,498,533,2870
E02005305,1410,609,447,507,2973
E02005306,1314,562,387,518,2781
E02005307,1460,577,425,520,2982
E02005308,937,501,404,445,2287
E02005309,1574,531,404,599,3108
E02005310,1259,425,345,529,2558
E02005311,1044,411,316,402,2173
E02005312,1334,366,205,261,2166
E02005313,1400,296,217,244,2157
E02005314,1149,291,251,313,2004
E02005315,1485,576,496,795,3352
E02005316,938,229,195,197,1559
E02005317,961,253,178,151,1543
E02005318,1416,449,324,494,2683
E02005319,1503,395,291,395,2584
E02005320,1118,305,252,406,2081
E02005321,1171,405,360,478,2414
E02005322,1712,1011,745,941,4409
E02005323,1451,429,291,334,2505
E02005324,985,426,297,443,2151
E02005325,1534,830,684,939,3987
E02005326,1636,661,492,734,3523
E02005327,1029,493,359,401,2282
E02005328,1740,634,492,647,3513
E02005329,1967,497,367,573,3404
E02005330,2097,720,554,651,4022
E02005331,2064,583,418,723,3788
E02005332,2198,608,489,693,3988
E02000984,1414,542,374,341,2671
E02000985,1359,550,414,576,2899
E02000986,1401,430,336,509,2676
E02000987,1207,391,318,375,2291
E02000988,1260,317,231,360,2168
E02000989,1339,647,546,738,3270
E02000990,1387,500,331,327,2545
E02000991,1175,365,269,331,2140
E02000992,928,371,316,397,2012
E02000993,1135,257,135,166,1693
E02000994,892,230,164,176,1462
E02000995,1177,450,289,501,2417
E02000996,913,304,219,330,1766
E02000997,1063,334,283,366,2046
E02000998,1034,256,171,226,1687
E02000999,902,221,161,210,1494
E02001000,1229,411,306,443,2389
E02001001,1244,280,218,322,2064
E02001002,1204,562,350,339,2455
E02001003,1420,512,378,506,2816
E02001004,955,176,136,178,1445
E02001005,1013,225,139,250,1627
E02001006,1129,185,130,179,1623
E02001007,1597,790,551,457,3395
E02001008,1027,190,165,285,1667
E02001009,1140,288,246,293,1967
E02001010,961,187,113,213,1474
E02001011,1385,596,407,467,2855
E02001012,1403,275,211,235,2124
E02001013,1069,314,329,380,2092
E02001014,1108,406,299,345,2158
E02001015,1574,394,282,335,2585
E02001016,1494,302,164,201,2161
E02001017,2001,537,377,385,3300
E02001018,1140,397,203,197,1937
E02001019,1659,492,339,416,2906
E02001020,1131,551,390,485,2557
E02001021,1535,437,314,401,2687
E02001022,1536,472,341,465,2814
E02001023,1134,396,258,249,2037
E02001024,1605,482,329,365,2781
E02001025,1420,321,203,293,2237
E02001026,1445,268,174,189,2076
E02001027,1274,283,175,280,2012
E02001028,1422,610,519,616,3167
E02001029,1201,254,156,220,1831
E02001030,1161,340,223,232,1956
E02001031,1227,303,243,288,2061
E02001032,1329,405,330,332,2396
E02001033,960,248,129,178,1515
E02001034,1289,320,222,328,2159
E02001035,1413,432,364,494,2703
E02001036,1237,353,196,227,2013
E02001037,1476,482,351,517,2826
E02001038,1034,251,175,281,1741
E02001039,1420,275,208,297,2200
E02001040,1223,315,261,311,2110
E02001041,1385,314,208,360,2267
E02001042,1357,315,225,268,2165
E02001043,1024,211,170,283,1688
E02001044,1411,269,184,241,2105
E02001045,1332,341,214,262,2149
E02001046,1696,297,206,244,2443
E02001047,1561,375,243,349,2528
E02001048,1392,295,195,287,2169
E02001049,1373,411,284,425,2493
E02001050,945,204,134,157,1440
E02001051,1093,226,179,234,1732
E02001052,1846,238,161,300,2545
E02001053,1179,259,158,203,1799
E02001055,1001,328,226,248,1803
E02001056,998,246,163,193,1600
E02001057,1295,213,105,144,1757
E02001059,1141,197,172,187,1697
E02001061,1217,281,181,229,1908
E02001062,1022,129,101,142,1394
E02001063,876,56,53,60,1045
E02001064,1193,193,148,226,1760
E02001065,1064,229,177,217,1687
E02001066,1038,135,73,127,1373
E02001067,1172,199,137,169,1677
E02001068,802,110,97,174,1183
E02001069,1137,121,96,128,1482
E02001070,1260,153,92,149,1654
E02001071,1213,232,129,189,1763
E02001072,1105,119,95,158,1477
E02001073,1561,246,153,287,2247
E02001074,1665,235,177,340,2417
E02001075,1069,128,98,102,1397
E02001076,898,104,56,99,1157
E02001077,1243,230,163,182,1818
E02001078,1516,307,248,341,2412
E02001079,1278,187,138,181,1784
E02001080,1092,149,143,175,1559
E02001081,1031,202,127,158,1518
E02001082,1110,176,96,135,1517
E02001083,1260,117,88,109,1574
E02001084,1437,258,138,207,2040
E02001085,1103,211,168,178,1660
E02001086,1067,186,151,242,1646
E02001087,1833,373,276,372,2854
E02001088,1392,299,163,290,2144
E02001089,1465,312,200,330,2307
E02001090,1384,291,203,293,2171
E02001091,1488,388,293,335,2504
E02001092,1506,290,176,229,2201
E02001093,1455,303,215,276,2249
E02001094,1398,272,161,160,1991
E02001095,1706,332,190,196,2424
E02001096,1466,361,183,256,2266
E02001097,1473,293,165,220,2151
E02006902,586,56,35,42,719
E02006912,902,94,51,109,1156
E02006913,854,98,72,89,1113
E02006914,465,14,19,21,519
E02006915,1111,106,79,78,1374
E02006916,664,57,32,44,797
E02006917,554,39,26,13,632
E02001098,1064,479,376,391,2310
E02001099,960,296,218,233,1707
E02001100,1045,387,313,345,2090
E02001101,1158,428,305,283,2174
E02001102,1057,315,195,205,1772
E02001103,860,387,286,374,1907
E02001104,998,307,176,209,1690
E02001105,997,408,312,341,2058
E02001106,1044,342,270,359,2015
E02001107,791,271,202,267,1531
E02001108,708,163,110,172,1153
E02001109,1054,311,186,239,1790
E02001110,997,460,323,369,2149
E02001111,847,184,125,185,1341
E02001112,1019,411,230,248,1908
E02001113,551,125,101,137,914
E02001114,1140,370,324,383,2217
E02001115,925,292,232,262,1711
E02001116,677,157,96,139,1069
E02001117,977,436,310,378,2101
E02001118,988,376,281,404,2049
E02001119,815,154,106,245,1320
E02001121,550,98,87,112,847
E02001123,994,228,159,205,1586
E02001124,785,221,167,188,1361
E02001125,1153,359,232,377,2121
E02001126,996,202,158,207,1563
E02001127,907,251,185,180,1523
E02001128,1011,337,283,300,1931
E02001129,791,257,156,251,1455
E02001130,819,263,227,320,1629
E02001131,703,244,242,306,1495
E02006860,1228,251,148,310,1937
E02001132,1259,360,261,305,2185
E02001133,1425,398,277,219,2319
E02001134,1259,416,300,289,2264
E02001135,1099,262,211,204,1776
E02001136,1919,473,335,412,3139
E02001137,1300,362,232,242,2136
E02001138,1889,552,408,543,3392
E02001139,1182,179,116,169,1646
E02001140,1257,280,187,304,2028
E02001141,1566,270,179,251,2266
E02001142,1243,394,325,443,2405
E02001143,1647,278,197,253,2375
E02001144,1196,342,237,251,2026
E02001145,1406,434,306,282,2428
E02001146,1083,175,133,208,1599
E02001147,1553,320,205,268,2346
E02001148,1733,549,369,444,3095
E02001149,1553,486,290,388,2717
E02001150,1370,428,230,298,2326
E02001151,1630,512,356,417,2915
E02001152,1419,396,259,297,2371
E02001153,1406,382,234,300,2322
E02001154,1472,396,220,335,2423
E02001155,1059,327,228,312,1926
E02001156,1607,529,379,606,3121
E02001157,1048,250,163,277,1738
E02001158,946,267,148,246,1607
E02001159,1153,229,159,172,1713
E02001160,1041,261,172,230,1704
E02001161,971,264,214,322,1771
E02001162,872,359,227,349,1807
E02001163,1710,524,403,480,3117
E02001164,1032,224,142,150,1548
E02001165,1053,241,194,246,1734
E02001166,831,226,166,273,1496
E02001167,990,255,155,220,1620
E02001168,1587,431,260,403,2681
E02001169,1975,653,424,489,3541
E02001170,1470,571,428,678,3147
E02001171,1137,329,232,332,2030
E02001172,1595,289,224,337,2445
E02001173,973,209,136,149,1467
E02001174,1055,257,171,253,1736
E02001175,980,239,174,227,1620
E02001176,1719,508,370,595,3192
E02001177,2030,429,309,481,3249
E02001178,1767,131,73,102,2073
E02001179,925,222,146,187,1480
E02001180,677,160,96,130,1063
E02001181,804,186,124,164,1278
E02001182,826,207,133,202,1368
E02001183,955,185,138,171,1449
E02001184,1915,260,150,157,2482
E02001185,1476,425,399,494,2794
E02001186,1384,403,308,366,2461
E02001187,1248,338,265,278,2129
E02001188,1162,288,165,189,1804
E02001189,1522,393,287,359,2561
E02001190,1132,203,127,240,1702
E02001191,764,412,265,367,1808
E02001192,1159,223,196,364,1942
E02001193,969,235,152,223,1579
E02001194,1060,325,221,365,1971
E02001195,883,399,320,381,1983
E02001196,1027,514,404,594,2539
E02001197,1136,277,196,251,1860
E02001198,880,416,371,613,2280
E02001199,1363,429,264,373,2429
E02001200,1089,255,151,213,1708
E02001201,872,239,174,255,1540
E02001202,758,204,125,143,1230
E02001203,989,436,349,418,2192
E02001204,1223,344,204,328,2099
E02001205,1198,329,232,269,2028
E02001206,1162,464,316,599,2541
E02001207,1288,435,273,377,2373
E02001208,1265,305,225,386,2181
E02001209,1095,281,167,260,1803
E02001210,1140,286,283,360,2069
E02001211,1291,322,248,367,2228
E02001212,900,190,127,196,1413
E02001213,1597,418,324,463,2802
E02001214,1548,461,359,565,2933
E02001215,1024,484,337,482,2327
E02001216,1289,443,335,498,2565
E02001217,990,374,253,458,2075
E02001218,1024,367,274,420,2085
E02001219,894,369,305,399,1967
E02001220,943,307,234,281,1765
E02001221,983,378,328,466,2155
E02001222,1234,408,300,472,2414
E02001223,1180,400,345,542,2467
E02001224,1043,521,437,599,2600
E02001225,1172,425,307,490,2394
E02001226,1293,334,247,404,2278
E02001227,884,358,331,515,2088
E02001228,983,345,311,535,2174
E02001229,1767,532,331,329,2959
E02001230,1261,417,321,282,2281
E02001231,1144,393,193,181,1911
E02001232,1587,360,243,265,2455
E02001233,1410,418,275,328,2431
E02001234,1319,327,206,264,2116
E02001235,1448,254,201,223,2126
E02001236,882,236,158,237,1513
E02001237,1027,308,184,238,1757
E02001238,1239,418,280,345,2282
E02001239,1383,353,277,326,2339
E02001240,923,296,192,233,1644
E02001241,1496,286,164,174,2120
E02001242,1130,304,246,307,1987
E02001243,1360,522,364,389,2635
E02001244,1006,373,276,253,1908
E02001245,1254,333,209,237,2033
E02001246,1145,372,217,362,2096
E02001247,1078,284,201,272,1835
E02001248,1478,415,247,233,2373
E02001249,840,256,201,242,1539
E02001250,1033,378,277,249,1937
E02001251,968,411,270,307,1956
E02001252,1225,397,300,459,2381
E02001253,765,241,198,222,1426
E02001254,757,321,218,237,1533
E02001255,833,242,149,218,1442
E02001256,1071,331,258,392,2052
E02001257,1340,468,390,505,2703
E02001258,1058,440,305,447,2250
E02001259,1110,173,103,212,1598
E02001260,1189,413,322,352,2276
E02001261,953,219,147,206,1525
E02001262,1149,236,159,311,1855
E02001263,1330,481,402,588,2801
E02001264,1108,272,219,291,1890
E02001265,1204,432,275,381,2292
E02001266,879,303,209,296,1687
E02001267,991,338,243,454,2026
E02001268,1132,437,330,461,2360
E02001269,1074,323,186,320,1903
E02001270,1179,317,245,428,2169
E02001271,1078,294,197,310,1879
E02001272,1296,399,306,455,2456
E02001273,1272,382,289,531,2474
E02001274,1397,491,401,596,2885
E02001275,1030,332,211,310,1883
E02001276,1290,375,236,339,2240
E02001277,1345,268,237,203,2053
E02001278,1355,416,279,388,2438
E02001279,1542,434,304,408,2688
E02001280,1415,420,335,466,2636
E02001281,1305,432,369,561,2667
E02001282,1716,341,253,351,2661
E02001283,1690,433,384,620,3127
E02001284,1741,331,237,341,2650
E02001285,1468,434,351,591,2844
E02001286,1988,439,387,665,3479
E02001287,987,337,274,281,1879
E02001288,1328,520,351,476,2675
E02001289,1517,731,539,644,3431
E02001290,811,355,286,390,1842
E02001291,1072,375,300,334,2081
E02001292,1188,434,365,505,2492
E02001293,846,395,293,301,1835
E02001294,1093,321,203,372,1989
E02001295,872,294,211,252,1629
E02001296,861,298,200,229,1588
E02001297,839,347,221,242,1649
E02001298,855,335,222,227,1639
E02001299,1223,408,344,371,2346
E02001300,1113,414,359,395,2281
E02001301,1179,373,247,352,2151
E02001302,1103,437,338,361,2239
E02001303,1093,332,229,242,1896
E02001304,2004,779,603,824,4210
E02001305,1158,543,428,410,2539
E02001306,1211,557,381,343,2492
E02001307,1881,778,491,413,3563
E02001308,836,332,295,324,1787
E02001309,1178,405,316,388,2287
E02001310,1139,394,272,256,2061
E02001311,1147,437,278,323,2185
E02001312,1082,362,253,196,1893
E02001313,979,367,275,278,1899
E02001314,1253,390,251,222,2116
E02001315,1299,487,388,378,2552
E02001316,738,238,179,165,1320
E02001317,1182,446,346,373,2347
E02001318,1005,484,367,401,2257
E02001319,1039,377,241,256,1913
E02001320,955,385,347,333,2020
E02001321,1153,464,362,357,2336
E02001322,1005,464,421,468,2358
E02001323,1014,430,360,378,2182
E02001324,1026,414,291,352,2083
E02001325,1250,522,397,378,2547
E02001326,1034,505,396,393,2328
E02001327,1490,344,149,116,2099
E02001328,1891,504,309,356,3060
E02001329,1329,252,122,214,1917
E02001330,1599,353,175,261,2388
E02001331,1663,481,250,370,2764
E02001332,1042,252,270,312,1876
E02001333,1599,344,264,391,2598
E02001334,961,193,146,150,1450
E02001335,1726,348,210,345,2629
E02001336,1050,243,144,257,1694
E02001337,1006,226,138,298,1668
E02001338,965,242,192,289,1688
E02001339,1031,260,221,266,1778
E02001340,1825,438,312,526,3101
E02001341,1253,305,197,312,2067
E02001342,1477,406,309,612,2804
E02001343,1391,414,272,328,2405
E02001344,953,270,129,270,1622
E02001345,932,302,215,301,1750
E02001346,1176,263,149,283,1871
E02001347,1469,279,179,302,2229
E02001348,1071,269,221,258,1819
E02001349,1264,346,218,287,2115
E02001350,1474,344,225,395,2438
E02001351,1513,294,201,254,2262
E02001352,1105,234,163,208,1710
E02001353,1418,289,170,226,2103
E02001354,1385,309,190,263,2147
E02001355,1096,289,190,234,1809
E02001356,1148,208,152,155,1663
E02001357,1227,234,179,311,1951
E02001358,916,258,161,204,1539
E02001359,1094,306,199,270,1869
E02001360,1157,395,222,253,2027
E02001361,1397,327,246,291,2261
E02001362,1370,365,248,453,2436
E02001363,1174,243,201,255,1873
E02001364,888,212,108,198,1406
E02001365,1280,250,194,308,2032
E02001366,1488,321,221,337,2367
E02001367,1811,543,367,555,3276
E02001368,1191,325,221,258,1995
E02001369,1317,379,224,264,2184
E02001370,1111,284,234,247,1876
E02001371,1197,242,176,304,1919
E02001372,1288,310,192,406,2196
E02001373,1717,354,198,326,2595
E02001374,1214,222,164,158,1758
E02001375,1426,312,227,339,2304
E02001376,1139,206,150,197,1692
E02001377,1224,206,158,219,1807
E02001378,1425,376,202,345,2348
E02001380,1547,434,270,371,2622
E02001381,1107,254,160,178,1699
E02001382,1449,356,252,360,2417
E02001383,995,192,83,141,1411
E02001384,1256,160,101,161,1678
E02001385,743,123,89,172,1127
E02001386,1502,470,329,394,2695
E02001387,1690,464,279,445,2878
E02001388,1353,226,149,259,1987
E02001389,1013,177,93,98,1381
E02001390,1507,308,194,281,2290
E02001391,910,280,213,262,1665
E02001392,1227,414,310,535,2486
E02001393,1591,554,360,483,2988
E02001394,1503,366,275,409,2553
E02001395,1109,306,224,316,1955
E02001396,1279,320,203,207,2009
E02001397,1464,464,298,530,2756
E02001398,1318,337,215,336,2206
E02001399,1362,392,273,408,2435
E02001400,1245,311,230,317,2103
E02001401,1337,444,295,532,2608
E02001402,1537,484,350,453,2824
E02001403,940,208,136,175,1459
E02001404,1101,218,175,203,1697
E02001405,1437,337,178,231,2183
E02006932,1109,61,39,33,1242
E02006933,1328,167,93,82,1670
E02006934,857,62,26,26,971
E02001406,1368,662,571,653,3254
E02001407,1086,516,402,469,2473
E02001408,899,449,312,295,1955
E02001409,1750,677,392,442,3261
E02001410,842,330,239,265,1676
E02001411,879,326,275,396,1876
E02001412,1604,497,298,487,2886
E02001413,1665,731,443,388,3227
E02001414,977,406,283,492,2158
E02001415,945,268,210,213,1636
E02001416,927,267,138,205,1537
E02001417,1118,262,196,266,1842
E02001418,900,204,181,247,1532
E02001419,1111,256,196,267,1830
E02001420,1683,442,319,483,2927
E02001421,1950,459,379,422,3210
E02001422,1015,206,145,206,1572
E02001423,1231,415,325,396,2367
E02001424,2496,674,452,645,4267
E02001425,1911,643,451,526,3531
E02001426,1028,308,280,443,2059
E02001427,1704,556,355,343,2958
E02001428,1016,376,384,531,2307
E02001429,1239,527,392,587,2745
E02001430,1262,514,383,617,2776
E02001431,1283,665,569,1042,3559
E02001432,1241,437,359,673,2710
E02001433,1236,293,205,282,2016
E02001434,1288,298,216,227,2029
E02001435,1232,349,222,322,2125
E02001436,1676,452,316,453,2897
E02001437,1624,762,624,1236,4246
E02001438,1324,369,283,332,2308
E02001439,1169,357,280,426,2232
E02001440,1099,595,528,659,2881
E02001441,1164,548,503,631,2846
E02001442,985,457,410,696,2548
E02001443,930,412,343,552,2237
E02001444,959,351,324,465,2099
E02001445,1315,467,358,568,2708
E02001446,1288,431,354,562,2635
E02001447,1062,380,327,553,2322
E02001448,1224,387,286,517,2414
E02001449,1774,565,438,573,3350
E02001450,1531,607,408,660,3206
E02001451,925,287,183,361,1756
E02001452,946,261,173,302,1682
E02001453,1584,473,374,502,2933
E02001454,1207,363,279,495,2344
E02001455,1131,342,237,416,2126
E02001456,1346,351,270,413,2380
E02001457,1077,233,145,263,1718
E02001458,1292,322,196,270,2080
E02001459,1128,280,195,285,1888
E02001460,1172,350,262,409,2193
E02001461,1118,339,238,284,1979
E02001462,1064,253,167,185,1669
E02001463,1035,277,188,288,1788
E02001464,856,257,177,180,1470
E02001465,966,272,176,204,1618
E02001466,1202,329,270,331,2132
E02001467,1449,428,372,483,2732
E02001468,1465,338,265,383,2451
E02001469,1507,464,359,526,2856
E02001470,1736,456,348,431,2971
E02001471,1237,329,198,276,2040
E02001472,1284,329,195,306,2114
E02001473,1358,387,280,382,2407
E02001474,1114,231,159,206,1710
E02001475,938,284,193,264,1679
E02001476,1282,285,175,232,1974
E02001477,1264,220,153,199,1836
E02001478,1373,584,339,510,2806
E02001479,1174,405,251,334,2164
E02001480,1408,474,328,688,2898
E02001481,1715,462,350,429,2956
E02001482,1515,286,177,232,2210
E02001483,1339,503,339,397,2578
E02001484,1468,523,365,576,2932
E02001485,1260,291,189,290,2030
E02001486,1546,563,382,670,3161
E02001487,1441,279,209,182,2111
E02001488,1412,365,249,339,2365
E02001489,1359,700,470,681,3210
E02001490,1575,563,386,406,2930
E02001491,1314,318,176,288,2096
E02001492,1387,500,365,643,2895
E02001493,1351,301,198,250,2100
E02001494,1399,585,405,536,2925
E02001495,1406,356,260,355,2377
E02001496,1148,341,278,371,2138
E02001497,1178,356,220,316,2070
E02001498,1350,397,287,375,2409
E02001499,1428,518,359,603,2908
E02001500,1604,536,389,586,3115
E02001501,1437,465,333,436,2671
E02001502,1551,456,359,519,2885
E02001503,1552,532,451,698,3233
E02001504,1303,643,499,693,3138
E02001505,1139,334,270,413,2156
E02001506,1820,763,570,923,4076
E02001507,1235,533,431,569,2768
E02001508,1372,410,288,438,2508
E02003314,1159,457,305,329,2250
E02003315,978,393,216,220,1807
E02003316,1765,576,416,418,3175
E02003317,1073,311,242,349,1975
E02003318,795,346,246,325,1712
E02003319,930,239,170,238,1577
E02003320,844,241,176,177,1438
E02003321,725,278,205,271,1479
E02003322,623,154,104,152,1033
E02003323,727,199,146,199,1271
E02003324,1000,309,185,230,1724
E02003325,758,126,114,135,1133
E02003326,817,261,187,214,1479
E02003327,781,283,216,278,1558
E02003328,821,180,147,194,1342
E02003329,860,172,117,120,1269
E02003330,771,216,155,194,1336
E02003331,1072,398,311,414,2195
E02003332,719,287,199,319,1524
E02003333,544,154,110,165,973
E02003334,603,169,136,195,1103
E02003335,580,151,102,100,933
E02003336,793,376,302,445,1916
E02003337,883,284,200,336,1703
E02003338,767,368,268,300,1703
E02003339,795,293,259,368,1715
E02003340,984,339,233,343,1899
E02003341,805,377,254,281,1717
E02003342,721,410,303,380,1814
E02003343,769,469,349,420,2007
E02003344,837,323,174,201,1535
E02003345,712,328,183,183,1406
E02003346,873,396,285,389,1943
E02003347,750,207,122,133,1212
E02003348,1171,587,396,546,2700
E02003349,863,495,365,399,2122
E02003350,809,338,241,321,1709
E02003351,896,417,314,265,1892
E02003352,725,378,332,419,1854
E02003353,1275,409,295,374,2353
E02003354,1172,353,237,358,2120
E02003355,800,164,128,227,1319
E02003356,933,289,223,368,1813
E02003357,1138,277,188,401,2004
E02003358,1282,295,241,389,2207
E02003359,813,184,109,114,1220
E02003360,1499,437,308,252,2496
E02003361,987,301,209,229,1726
E02003362,984,316,199,193,1692
E02003363,818,341,297,513,1969
E02003364,927,283,214,172,1596
E02003365,895,363,242,317,1817
E02003366,809,315,163,258,1545
E02003367,660,331,255,270,1516
E02003368,514,358,297,315,1484
E02003369,771,345,276,404,1796
E02003370,896,419,316,368,1999
E02003371,813,313,262,373,1761
E02003372,1034,416,302,440,2192
E02003373,852,419,295,371,1937
E02003374,763,278,176,198,1415
E02003375,736,281,222,263,1502
E02003376,596,352,305,388,1641
E02003377,1034,593,402,460,2489
E02003378,809,456,365,561,2191
E02003379,639,274,186,309,1408
E02003380,877,405,249,241,1772
E02003381,713,286,183,286,1468
E02003382,782,355,284,388,1809
E02003383,710,310,180,217,1417
E02003384,705,405,305,418,1833
E02003385,1018,354,280,423,2075
E02003386,827,423,307,353,1910
E02003387,905,561,414,560,2440
E02003388,728,319,278,325,1650
E02003389,731,487,358,485,2061
E02003390,738,389,305,439,1871
E02003391,701,380,321,525,1927
E02003392,650,230,194,275,1349
E02003393,1060,370,311,455,2196
E02003394,784,240,152,255,1431
E02003395,917,160,112,156,1345
E02003396,958,247,183,263,1651
E02003397,1007,334,253,411,2005
E02003398,1041,208,143,167,1559
E02003399,1057,176,126,138,1497
E02003400,792,195,143,284,1414
E02003401,856,198,174,411,1639
E02003402,1087,213,153,163,1616
E02003403,1117,345,284,427,2173
E02003404,752,175,159,253,1339
E02003405,1322,273,198,222,2015
E02003406,1083,268,174,252,1777
E02003407,1233,216,109,227,1785
E02003408,1166,253,161,267,1847
E02003409,1242,274,194,266,1976
E02003410,1252,223,159,266,1900
E02003411,1628,251,184,350,2413
E02003412,1092,307,193,269,1861
E02003413,1444,274,171,290,2179
E02003414,1275,271,171,182,1899
E02003415,929,195,137,269,1530
E02003416,1045,239,183,267,1734
E02003417,1193,282,188,290,1953
E02003418,1168,244,142,247,1801
E02003419,988,210,160,272,1630
E02003420,638,143,92,103,976
E02003421,617,308,244,341,1510
E02003422,1248,731,547,737,3263
E02003423,785,229,177,228,1419
E02003424,986,451,389,597,2423
E02003425,1130,328,318,480,2256
E02003426,1065,421,315,567,2368
E02003427,887,243,175,293,1598
E02003428,1236,474,342,388,2440
E02003429,980,441,346,425,2192
E02003430,677,234,145,262,1318
E02003431,753,311,232,291,1587
E02003432,753,243,156,348,1500
E02003433,855,318,296,423,1892
E02003434,1115,353,260,519,2247
E02003435,867,322,263,298,1750
E02003436,1156,502,351,547,2556
E02003437,951,366,292,363,1972
E02003438,1155,581,448,803,2987
E02003439,649,354,296,426,1725
E02003440,1004,461,385,516,2366
E02003441,891,391,351,552,2185
E02003442,827,308,206,271,1612
E02003443,685,302,252,504,1743
E02003444,979,319,288,469,2055
E02003445,942,439,376,467,2224
E02003446,889,449,317,397,2052
E02003447,1032,384,286,399,2101
E02003448,862,398,276,362,1898
E02003449,712,206,140,167,1225
E02003450,1244,407,263,437,2351
E02003451,1051,430,382,725,2588
E02003452,950,325,284,336,1895
E02003453,808,362,240,255,1665
E02003454,908,421,333,514,2176
E02003455,808,401,261,329,1799
E02003456,681,284,204,296,1465
E02003457,1238,615,423,475,2751
E02003458,1163,484,378,483,2508
E02003459,1243,580,410,587,2820
E02003460,1331,656,447,542,2976
E02003461,778,519,320,477,2094
E02003462,888,384,273,330,1875
E02003463,822,414,254,271,1761
E02003464,722,259,152,132,1265
E02003465,845,375,260,373,1853
E02003466,624,228,122,177,1151
E02003467,649,285,193,297,1424
E02003468,831,447,333,411,2022
E02003469,680,319,186,211,1396
E02003470,484,156,108,79,827
E02003471,720,256,148,168,1292
E02003472,688,165,77,97,1027
E02003473,521,253,166,164,1104
E02003474,916,331,175,180,1602
E02003475,2012,367,210,294,2883
E02003476,981,232,126,168,1507
E02003477,1453,442,320,414,2629
E02003478,661,256,156,191,1264
E02003479,756,216,96,105,1173
E02003480,1052,221,129,136,1538
E02003481,765,209,146,171,1291
E02003482,1071,374,257,362,2064
E02003483,980,208,99,126,1413
E02003484,839,309,189,181,1518
E02003485,1000,367,323,401,2091
E02003486,990,232,140,142,1504
E02003487,1087,437,336,386,2246
E02003488,975,352,304,355,1986
E02003489,953,402,250,426,2031
E02003490,1021,295,182,200,1698
E02003491,1014,349,236,378,1977
E02003492,862,193,135,201,1391
E02003493,1097,414,323,669,2503
E02003494,967,343,207,313,1830
E02003495,1035,327,258,294,1914
E02003496,980,359,245,476,2060
E02003497,1051,377,286,406,2120
E02003498,995,229,172,242,1638
E02003499,939,210,180,235,1564
E02003500,1160,247,128,145,1680
E02003501,1035,313,212,301,1861
E02003502,1154,318,203,297,1972
E02003503,1234,369,231,398,2232
E02003504,1120,253,164,201,1738
E02003505,971,137,80,97,1285
E02003506,801,163,109,144,1217
E02003507,1537,491,400,561,2989
E02003508,1090,191,104,142,1527
E02003509,929,249,198,248,1624
E02003510,1096,287,215,414,2012
E02003511,1203,273,202,312,1990
E02003512,1033,151,93,91,1368
E02003513,861,253,201,385,1700
E02003514,941,179,108,141,1369
E02003515,1503,288,182,248,2221
E02003516,959,211,161,225,1556
E02003517,1080,230,152,173,1635
E02003518,993,277,248,406,1924
E02003519,1045,166,96,123,1430
E02003520,1243,236,144,198,1821
E02003521,1292,313,223,349,2177
E02003522,1278,337,215,266,2096
E02003523,1502,676,585,814,3577
E02003524,1393,309,196,223,2121
E02003525,1320,221,141,176,1858
E02003526,1198,443,360,678,2679
E02003527,959,342,230,269,1800
E02003529,1435,329,254,386,2404
E02003530,1159,343,248,329,2079
E02003531,1272,382,285,368,2307
E02003532,1187,263,222,207,1879
E02003533,860,189,159,190,1398
E02003534,1255,321,215,238,2029
E02003535,1340,252,169,215,1976
E02003536,1013,282,193,232,1720
E02003537,1660,416,293,424,2793
E02003538,1237,234,180,244,1895
E02003539,1549,305,240,299,2393
E02003540,1497,438,421,572,2928
E02003541,996,269,211,346,1822
E02003542,1068,253,169,252,1742
E02003543,922,231,124,188,1465
E02003544,924,189,125,178,1416
E02003545,837,258,188,328,1611
E02003546,1201,379,313,431,2324
E02003547,977,448,324,596,2345
E02003548,867,211,160,296,1534
E02006821,1043,315,264,433,2055
E02003549,1321,296,203,325,2145
E02003550,1650,434,274,259,2617
E02003551,881,247,172,195,1495
E02003552,1207,346,222,237,2012
E02003553,892,155,91,144,1282
E02003554,1175,329,245,403,2152
E02003555,1513,343,215,294,2365
E02003556,753,250,239,291,1533
E02003557,1030,256,212,343,1841
E02003558,1365,213,178,227,1983
E02003559,1365,364,250,377,2356
E02003560,1008,226,160,229,1623
E02003561,985,206,151,257,1599
E02003562,1016,287,233,331,1867
E02003563,1210,273,209,358,2050
E02003564,939,334,270,444,1987
E02003565,779,113,85,146,1123
E02003566,790,302,237,350,1679
E02003567,1191,257,193,195,1836
E02003568,1102,184,176,212,1674
E02003569,950,181,145,166,1442
E02003570,821,122,63,109,1115
E02003571,730,121,108,244,1203
E02003572,774,274,210,298,1556
E02003573,869,321,272,408,1870
E02003574,969,436,352,382,2139
E02003575,664,214,202,213,1293
E02003576,1071,296,207,270,1844
E02003577,1085,187,131,145,1548
E02003578,875,272,216,261,1624
E02003579,1287,320,244,379,2230
E02003580,738,223,148,165,1274
E02003581,1535,411,344,434,2724
E02003582,1865,602,490,592,3549
E02003583,1466,598,494,432,2990
E02003584,1039,372,251,329,1991
E02003585,1241,612,530,634,3017
E02003586,1262,521,410,533,2726
E02003587,1301,476,339,385,2501
E02003588,1670,448,369,460,2947
E02003589,1468,336,235,313,2352
E02003590,1283,763,631,944,3621
E02003591,1810,571,464,610,3455
E02003592,2485,1042,818,1106,5451
E02003593,1226,479,402,452,2559
E02003594,1662,646,513,658,3479
E02003595,1528,768,632,724,3652
E02003596,1579,719,553,677,3528
E02003597,1094,546,359,432,2431
E02003598,1160,692,495,568,2915
E02003652,1258,443,331,434,2466
E02003653,896,340,250,370,1856
E02003654,837,381,287,258,1763
E02003655,1326,604,379,434,2743
E02003656,1035,384,311,423,2153
E02003657,1100,440,288,366,2194
E02003658,1415,552,370,461,2798
E02003659,1437,461,329,384,2611
E02003660,1290,591,415,485,2781
E02003661,753,294,208,260,1515
E02003662,903,200,156,203,1462
E02003663,1556,215,131,176,2078
E02003664,906,203,122,248,1479
E02003665,817,229,157,221,1424
E02003666,942,217,168,281,1608
E02003667,1232,292,180,171,1875
E02003668,1359,492,411,681,2943
E02003669,873,180,132,150,1335
E02003670,1685,380,248,331,2644
E02003671,823,204,114,95,1236
E02003672,1630,698,504,597,3429
E02003673,1311,626,482,644,3063
E02003674,601,372,289,305,1567
E02003675,1092,420,364,526,2402
E02003676,926,547,427,524,2424
E02003677,1020,437,314,457,2228
E02003678,621,269,193,348,1431
E02003679,640,259,217,375,1491
E02003680,1300,623,521,722,3166
E02003681,1246,469,454,755,2924
E02003682,955,390,289,416,2050
E02003683,1029,331,277,408,2045
E02003685,1147,470,338,506,2461
E02003686,1252,435,385,636,2708
E02003687,901,283,214,347,1745
E02003688,1103,506,442,892,2943
E02003689,1536,460,325,651,2972
E02003690,1190,367,311,581,2449
E02003691,865,384,292,517,2058
E02003692,1240,439,343,544,2566
E02003693,906,420,345,484,2155
E02003694,1115,342,235,404,2096
E02003695,1373,479,330,447,2629
E02003696,878,562,484,823,2747
E02003697,727,397,314,420,1858
E02003698,1086,582,451,554,2673
E02003699,1040,322,237,319,1918
E02003701,1418,469,427,598,2912
E02003702,940,442,351,422,2155
E02003703,990,241,213,260,1704
E02003704,633,334,255,278,1500
E02003705,782,148,99,170,1199
E02003706,695,211,157,255,1318
E02003707,696,196,100,147,1139
E02003708,980,121,90,173,1364
E02003709,595,139,108,170,1012
E02003710,1443,304,239,351,2337
E02003711,997,289,193,274,1753
E02003712,1023,433,324,519,2299
E02003713,626,325,285,469,1705
E02003714,701,299,243,256,1499
E02003715,719,411,336,344,1810
E02003716,537,341,288,422,1588
E02003717,899,535,451,683,2568
E02003718,529,280,227,332,1368
E02006823,1053,570,472,691,2786
E02006824,1137,536,475,643,2791
E02004356,1414,345,279,330,2368
E02004357,1474,396,232,261,2363
E02004358,1335,539,400,625,2899
E02004359,1649,510,427,691,3277
E02004361,1757,473,383,586,3199
E02004362,1667,419,285,386,2757
E02004363,1549,405,343,644,2941
E02004364,1882,548,369,649,3448
E02004365,1512,199,105,181,1997
E02004366,1265,446,346,817,2874
E02004367,1411,634,572,1086,3703
E02006857,1455,613,460,606,3134
E02006858,1098,564,406,374,2442
E02004368,1379,441,294,336,2450
E02004369,1638,834,654,907,4033
E02004370,1160,353,227,214,1954
E02004371,1168,354,245,260,2027
E02004372,951,228,144,210,1533
E02004373,1338,456,330,393,2517
E02004374,1169,382,269,349,2169
E02004375,1145,395,216,354,2110
E02004376,873,257,155,215,1500
E02004377,1646,586,434,675,3341
E02004378,1034,319,241,257,1851
E02004379,971,500,380,423,2274
E02004380,1289,616,485,851,3241
E02004381,1350,494,393,554,2791
E02004382,965,475,357,586,2383
E02004383,1001,407,273,453,2134
E02004384,1154,436,299,455,2344
E02004385,1208,511,387,539,2645
E02004386,977,404,337,377,2095
E02004387,749,211,146,176,1282
E02004388,1190,422,351,457,2420
E02004389,2188,857,714,1089,4848
E02004390,1704,720,564,753,3741
E02004391,1363,486,340,640,2829
E02004392,1452,604,458,570,3084
E02004393,988,593,445,572,2598
E02004394,1344,635,444,561,2984
E02004395,1190,646,492,633,2961
E02004396,1532,935,686,803,3956
E02004397,1303,566,450,604,2923
E02004398,1362,452,358,504,2676
E02004399,1363,673,555,845,3436
E02004400,1603,1247,946,1425,5221
E02004401,1139,847,672,1136,3794
E02004402,1452,647,510,846,3455
E02004403,778,385,310,357,1830
E02004404,847,411,279,372,1909
E02004405,801,424,334,448,2007
E02004406,1083,629,490,779,2981
E02004407,1037,535,436,636,2644
E02004408,1211,434,273,339,2257
E02004409,742,391,312,389,1834
E02004410,1080,608,468,529,2685
E02004411,1050,567,445,495,2557
E02004412,949,531,424,540,2444
E02004413,1008,478,399,555,2440
E02004414,834,318,228,275,1655
E02004415,990,444,336,407,2177
E02004416,969,531,386,413,2299
E02004417,1336,422,372,624,2754
E02004418,1205,356,317,464,2342
E02004419,1304,369,273,395,2341
E02004420,2780,1016,782,1020,5598
E02004421,1292,565,483,778,3118
E02004422,1673,788,601,764,3826
E02004423,1350,671,564,752,3337
E02004675,1108,411,317,364,2200
E02004676,1097,557,376,489,2519
E02004677,790,435,329,391,1945
E02004678,947,472,344,447,2210
E02004679,1294,454,319,465,2532
E02004680,995,255,189,163,1602
E02004681,1755,415,304,321,2795
E02004682,1033,315,224,235,1807
E02004683,944,253,217,363,1777
E02004684,1640,359,260,347,2606
E02004685,860,284,187,343,1674
E02004686,949,291,205,289,1734
E02004687,904,263,190,208,1565
E02004688,1046,340,232,415,2033
E02004689,838,493,349,420,2100
E02004690,1080,390,257,333,2060
E02004691,1101,531,378,630,2640
E02004692,1119,604,465,531,2719
E02004693,1026,309,177,212,1724
E02004694,817,419,307,426,1969
E02004695,1085,234,136,108,1563
E02004696,965,443,331,409,2148
E02004697,973,404,285,442,2104
E02004698,881,268,212,455,1816
E02004699,1613,691,524,756,3584
E02004700,849,185,114,133,1281
E02004702,1148,378,275,316,2117
E02004703,1623,921,627,743,3914
E02004704,798,348,279,304,1729
E02004705,1025,518,402,706,2651
E02004706,912,496,401,582,2391
E02004707,1264,682,589,808,3343
E02004708,989,501,375,632,2497
E02004709,1108,538,405,458,2509
E02004710,900,426,331,360,2017
E02006829,993,465,424,635,2517
E02006838,949,525,451,597,2522
E02004712,1009,530,503,775,2817
E02004713,1038,550,332,497,2417
E02004714,915,548,352,555,2370
E02004715,1035,405,275,417,2132
E02004716,1134,450,333,426,2343
E02004717,1274,370,270,451,2365
E02004718,928,257,168,246,1599
E02004719,1358,589,433,577,2957
E02004720,1831,688,533,788,3840
E02004721,1445,295,190,243,2173
E02004722,1154,390,313,491,2348
E02004723,1614,571,441,651,3277
E02004724,1389,384,296,336,2405
E02004725,905,343,237,424,1909
E02004726,913,352,259,309,1833
E02004727,1195,414,281,366,2256
E02004728,1153,478,366,544,2541
E02004729,995,398,326,428,2147
E02004730,1229,585,502,784,3100
E02004731,1031,469,349,511,2360
E02004732,1203,535,404,617,2759
E02004733,1101,471,320,445,2337
E02004734,1386,568,455,718,3127
E02004735,1080,556,502,685,2823
E02004736,1134,639,517,623,2913
E02004737,930,316,254,417,1917
E02004738,1073,486,366,532,2457
E02004739,1026,575,478,696,2775
E02004740,992,605,474,693,2764
E02004741,1102,516,353,474,2445
E02004742,1107,437,325,425,2294
E02004743,1096,409,293,326,2124
E02004744,1097,226,132,179,1634
E02004745,1184,388,252,294,2118
E02004746,1703,851,619,864,4037
E02004747,991,339,244,358,1932
E02004748,1207,452,342,425,2426
E02004749,1077,542,432,744,2795
E02004750,1130,462,360,540,2492
E02004751,1179,513,463,578,2733
E02004752,1152,532,342,350,2376
E02004753,1433,580,484,568,3065
E02004754,781,473,353,443,2050
E02004755,976,353,338,634,2301
E02004756,1032,459,292,328,2111
E02004757,841,550,447,638,2476
E02004758,930,472,378,533,2313
E02004759,908,437,363,554,2262
E02004760,1027,361,290,474,2152
E02004761,710,329,254,365,1658
E02004764,1238,646,518,807,3209
E02004765,899,389,310,394,1992
E02004766,1048,320,271,468,2107
E02004767,774,201,159,201,1335
E02004768,862,276,180,196,1514
E02004769,787,208,148,166,1309
E02004770,822,248,183,276,1529
E02004771,1133,341,216,341,2031
E02004772,1546,562,441,611,3160
E02004774,1786,752,661,1104,4303
E02004775,1464,641,440,665,3210
E02004776,1078,548,484,573,2683
E02004777,856,486,427,629,2398
E02004778,1099,609,457,646,2811
E02006822,1438,553,372,616,2979
E02006830,844,323,255,266,1688
E02006831,937,450,363,557,2307
E02004779,1622,822,625,938,4007
E02004780,914,354,242,348,1858
E02004781,1235,400,248,321,2204
E02004782,1112,410,324,549,2395
E02004783,1041,322,230,381,1974
E02004784,790,457,343,627,2217
E02004785,786,457,356,530,2129
E02004786,1388,423,301,309,2421
E02004787,1170,657,508,808,3143
E02004788,1139,492,394,481,2506
E02004789,1671,569,479,812,3531
E02004790,1121,479,397,696,2693
E02004791,915,302,216,244,1677
E02004792,1442,682,479,644,3247
E02004793,844,635,499,778,2756
E02004794,1164,576,384,535,2659
E02004795,956,710,557,902,3125
E02004796,1150,957,745,947,3799
E02004797,991,495,383,520,2389
E02004798,833,363,298,430,1924
E02004799,1031,628,564,1002,3225
E02004800,959,908,787,1202,3856
E02004801,770,900,742,1189,3601
E02004802,928,308,231,350,1817
E02004803,1009,307,204,206,1726
E02004804,945,402,250,267,1864
E02004805,972,438,345,427,2182
E02004806,1002,342,214,259,1817
E02004807,1097,381,333,477,2288
E02004808,1334,332,251,378,2295
E02004809,1207,272,208,160,1847
E02004810,1242,234,176,219,1871
E02004811,1182,406,296,433,2317
E02004812,1059,311,225,243,1838
E02004813,1028,245,196,304,1773
E02004814,786,404,288,325,1803
E02004815,645,206,168,151,1170
E02004816,1834,591,469,552,3446
E02004817,859,371,245,419,1894
E02004818,1061,643,495,666,2865
E02004819,906,372,349,585,2212
E02004820,804,436,297,387,1924
E02004821,639,395,332,334,1700
E02004822,1066,547,396,537,2546
E02004823,1165,666,484,601,2916
E02004824,692,465,386,814,2357
E02004825,1449,771,626,788,3634
E02004826,1294,569,429,532,2824
E02004827,905,319,206,234,1664
E02004828,1276,472,300,447,2495
E02004829,742,336,249,321,1648
E02004830,1044,377,299,341,2061
E02004831,1371,507,425,891,3194
E02004832,1099,609,555,773,3036
E02004833,1424,425,349,576,2774
E02004834,1012,271,251,389,1923
E02004835,1412,430,365,613,2820
E02004836,916,182,138,191,1427
E02004837,1273,486,341,483,2583
E02004838,1521,622,424,581,3148
E02004839,1272,567,417,557,2813
E02004840,1418,673,525,694,3310
E02004841,1441,567,405,560,2973
E02004842,1691,587,428,684,3390
E02004996,1102,464,377,486,2429
E02004997,1107,625,441,562,2735
E02004998,923,394,331,415,2063
E02004999,1980,653,480,633,3746
E02005000,1414,363,295,309,2381
E02005001,1610,534,350,453,2947
E02005002,1180,371,294,348,2193
E02005003,1196,305,207,218,1926
E02005004,1637,369,249,316,2571
E02005005,1265,596,417,459,2737
E02005006,928,466,355,431,2180
E02005007,1154,542,444,543,2683
E02005008,883,727,644,943,3197
E02005009,631,467,342,387,1827
E02005010,1118,409,317,532,2376
E02005011,1140,734,575,745,3194
E02005012,1478,617,463,568,3126
E02005013,1324,646,471,631,3072
E02005014,1374,818,604,827,3623
E02005015,1558,587,399,481,3025
E02005016,1119,519,405,521,2564
E02005017,908,443,318,434,2103
E02005018,1350,657,511,605,3123
E02005019,1002,406,272,428,2108
E02005020,1212,413,358,407,2390
E02005021,1069,478,371,491,2409
E02005022,804,263,179,255,1501
E02005023,1069,229,144,263,1705
E02005025,1255,446,296,496,2493
E02005026,1340,423,305,355,2423
E02005027,947,383,290,450,2070
E02006855,899,160,114,163,1336
E02006856,1143,354,295,510,2302
E02005028,1457,206,128,282,2073
E02005029,1331,241,150,184,1906
E02005030,1479,282,244,298,2303
E02005031,940,211,160,226,1537
E02005032,1207,255,158,222,1842
E02005033,983,249,155,173,1560
E02005034,1222,405,257,354,2238
E02005035,1312,363,243,419,2337
E02005036,936,231,171,199,1537
E02005037,1040,419,305,543,2307
E02005038,971,346,243,410,1970
E02005039,1105,310,258,318,1991
E02005040,1073,438,348,590,2449
E02005041,1181,512,394,455,2542
E02005042,1224,698,520,701,3143
E02005043,1200,538,413,540,2691
E02005044,1011,512,391,453,2367
E02005045,1628,458,372,429,2887
E02005046,1459,369,284,301,2413
E02005047,1371,477,438,568,2854
E02005048,1219,513,345,453,2530
E02005049,1374,672,560,634,3240
E02005050,1815,642,486,721,3664
E02005051,2200,483,292,329,3304
E02005052,1156,345,270,373,2144
E02005053,1354,308,183,252,2097
E02005054,1377,555,370,416,2718
E02005055,1023,202,140,174,1539
E02005056,1318,311,209,383,2221
E02005057,1619,384,227,385,2615
E02005058,1172,289,173,252,1886
E02005059,1664,404,313,493,2874
E02005060,1195,331,275,452,2253
E02005061,1128,289,240,319,1976
E02005062,1227,342,278,399,2246
E02005063,1235,320,239,339,2133
E02005064,1166,474,366,466,2472
E02005065,1297,268,211,302,2078
E02005066,1353,576,493,642,3064
E02005067,1068,415,281,330,2094
E02005068,993,377,210,229,1809
E02005069,1157,518,315,462,2452
E02005070,1392,663,519,877,3451
E02005071,1230,277,187,340,2034
E02005072,1338,559,372,418,2687
E02005073,1544,368,216,409,2537
E02005074,1461,572,421,619,3073
E02005075,1940,340,264,354,2898
E02005076,1131,249,173,310,1863
E02005077,965,408,295,368,2036
E02005078,2014,677,473,591,3755
E02005079,1089,556,463,563,2671
E02005080,1220,437,363,489,2509
E02005081,1104,502,406,547,2559
E02005082,2189,578,419,512,3698
E02005083,1060,441,393,484,2378
E02005084,1813,425,354,440,3032
E02005085,1154,363,268,351,2136
E02005086,834,388,304,356,1882
E02005087,1203,457,304,440,2404
E02005088,1613,428,262,462,2765
E02005089,1095,334,291,376,2096
E02005090,824,438,416,593,2271
E02005091,1113,401,306,445,2265
E02005093,985,460,361,392,2198
E02005094,1076,454,347,502,2379
E02005095,741,401,351,531,2024
E02005096,963,431,292,511,2197
E02005097,899,440,343,551,2233
E02005098,979,450,388,793,2610
E02005099,865,457,363,445,2130
E02005100,1130,507,412,556,2605
E02005101,870,440,273,343,1926
E02006832,863,414,277,210,1764
E02005102,1024,585,385,493,2487
E02005103,1452,534,366,424,2776
E02005104,1590,476,280,384,2730
E02005105,1312,258,168,184,1922
E02005106,1696,466,300,372,2834
E02005107,2458,850,568,783,4659
E02005109,1180,635,518,793,3126
E02005110,1216,527,431,485,2659
E02005111,1284,636,491,732,3143
E02005112,1139,648,459,530,2776
E02005113,1160,638,471,618,2887
E02005114,907,478,339,375,2099
E02006879,1026,222,166,240,1654
E02006880,1279,339,289,473,2380
E02005115,568,172,121,137,998
E02005116,647,241,197,234,1319
E02005117,908,526,389,400,2223
E02005118,1252,481,343,465,2541
E02005119,679,391,290,291,1651
E02005120,931,567,379,347,2224
E02005121,1943,504,283,270,3000
E02005122,981,482,335,393,2191
E02005123,1643,562,395,465,3065
E02005124,1045,333,242,366,1986
E02005125,1079,343,232,285,1939
E02005126,1080,517,413,541,2551
E02005127,1307,524,460,490,2781
E02005128,1158,510,369,469,2506
E02005129,1517,641,467,684,3309
E02005130,1190,490,375,474,2529
E02005131,817,398,300,314,1829
E02005132,1417,340,239,432,2428
E02005133,1730,816,591,776,3913
E02005134,1420,279,168,172,2039
E02005135,1480,316,248,314,2358
E02005136,1427,479,363,438,2707
E02005137,1387,352,247,310,2296
E02005138,1129,619,485,692,2925
E02005139,1115,917,742,1046,3820
E02005140,1133,654,522,719,3028
E02005141,874,561,374,503,2312
E02005142,980,531,408,559,2478
E02005143,889,419,326,412,2046
E02005144,908,373,241,295,1817
E02005145,1025,551,437,424,2437
E02005146,736,317,182,221,1456
E02005147,705,445,314,381,1845
E02005148,934,606,536,646,2722
E02005149,1347,540,432,474,2793
E02005150,1212,483,330,425,2450
E02005151,1440,641,535,608,3224
E02005153,1012,511,381,596,2500
E02005154,1296,656,512,698,3162
E02005155,1300,523,352,366,2541
E02005156,1028,466,360,464,2318
E02005157,942,387,325,489,2143
E02005158,908,400,301,438,2047
E02005159,1058,464,407,642,2571
E02005160,1435,433,345,640,2853
E02005161,1009,324,195,323,1851
E02006833,1370,693,503,636,3202
E02005162,1457,619,454,571,3101
E02005163,1142,367,250,348,2107
E02005164,1226,341,273,392,2232
E02005165,1261,485,385,484,2615
E02005166,1025,228,170,224,1647
E02005167,1090,489,338,510,2427
E02005168,1047,278,226,509,2060
E02005169,1140,295,189,278,1902
E02005170,1318,371,328,660,2677
E02005171,845,258,205,325,1633
E02005172,1238,455,379,397,2469
E02005173,1160,427,369,556,2512
E02005174,919,444,355,558,2276
E02005175,1113,528,406,543,2590
E02005921,1010,376,302,382,2070
E02005922,995,296,208,190,1689
E02005923,609,210,163,216,1198
E02005924,1100,295,228,449,2072
E02005925,880,326,213,272,1691
E02005926,1066,551,444,705,2766
E02005927,725,348,241,231,1545
E02005928,1220,604,464,569,2857
E02005929,920,515,342,413,2190
E02005930,1125,523,336,496,2480
E02005931,1140,428,265,400,2233
E02005932,741,196,125,101,1163
E02005933,908,338,236,276,1758
E02005934,1122,422,319,458,2321
E02005935,852,221,187,363,1623
E02005936,1412,525,399,501,2837
E02005937,740,415,315,585,2055
E02005938,622,265,181,344,1412
E02005939,736,375,248,467,1826
E02005940,823,327,245,399,1794
E02005941,794,327,244,363,1728
E02005942,621,286,246,318,1471
E02005943,951,258,208,388,1805
E02005944,1409,223,163,215,2010
E02005945,2053,334,286,431,3104
E02005946,1530,332,268,334,2464
E02005947,1249,160,151,158,1718
E02005948,567,181,144,173,1065
E02005949,1370,151,105,191,1817
E02005950,1046,274,143,185,1648
E02005951,569,193,132,215,1109
E02005952,1909,309,215,356,2789
E02005953,680,175,95,115,1065
E02005954,1057,336,282,497,2172
E02005955,1190,311,211,316,2028
E02005956,844,184,141,238,1407
E02005957,849,119,100,173,1241
E02005958,685,278,215,240,1418
E02005959,879,367,267,319,1832
E02005960,763,445,328,536,2072
E02005961,861,420,330,474,2085
E02005962,1086,599,456,493,2634
E02005963,1191,425,374,488,2478
E02005964,847,445,357,483,2132
E02005965,662,323,268,339,1592
E02005966,656,181,92,112,1041
E02005967,691,293,255,343,1582
E02005968,904,356,305,384,1949
E02005969,1384,483,430,669,2966
E02005970,488,170,127,126,911
E02005971,618,263,240,347,1468
E02005972,1260,507,411,581,2759
E02005973,662,365,337,574,1938
E02005974,701,306,308,477,1792
E02005975,1018,572,423,574,2587
E02005976,775,398,323,405,1901
E02005977,739,380,316,550,1985
E02005978,1002,464,326,579,2371
E02005979,1180,452,353,653,2638
E02005980,1259,589,493,672,3013
E02005981,1110,510,333,335,2288
E02005982,602,304,258,318,1482
E02005983,1078,473,355,686,2592
E02005984,1053,505,382,415,2355
E02005985,863,427,352,455,2097
E02005986,1263,539,370,553,2725
E02005987,1021,459,335,469,2284
E02005988,843,413,323,402,1981
E02005991,976,551,398,728,2653
E02005992,1266,622,481,693,3062
E02006886,1573,704,573,726,3576
E02005993,906,453,379,548,2286
E02005994,711,388,280,337,1716
E02005995,755,475,361,490,2081
E02005996,856,471,415,607,2349
E02005997,752,422,297,394,1865
E02005998,1010,443,347,512,2312
E02005999,884,430,316,436,2066
E02006000,1685,584,460,619,3348
E02006001,901,258,164,393,1716
E02006002,1517,543,454,789,3303
E02006003,854,315,324,365,1858
E02006004,607,420,302,385,1714
E02006005,837,252,203,244,1536
E02006006,571,254,228,312,1365
E02006007,809,466,337,487,2099
E02006317,944,320,230,358,1852
E02006318,909,339,271,340,1859
E02006319,989,287,203,300,1779
E02006320,855,224,175,230,1484
E02006321,891,271,200,360,1722
E02006322,825,261,182,259,1527
E02006323,873,335,240,500,1948
E02006324,1000,248,206,265,1719
E02006325,1241,386,284,437,2348
E02006326,828,330,222,348,1728
E02006327,758,304,279,457,1798
E02006328,1098,368,303,455,2224
E02006329,941,378,268,436,2023
E02006330,1246,435,384,631,2696
E02006331,1079,381,274,450,2184
E02006332,750,277,197,392,1616
E02006333,1133,421,333,554,2441
E02006334,1000,401,309,497,2207
E02006335,1121,429,356,463,2369
E02006336,1026,314,168,252,1760
E02006337,1225,496,352,527,2600
E02006338,1091,384,269,325,2069
E02006339,1579,352,232,246,2409
E02006341,1465,399,322,511,2697
E02006342,1057,335,264,559,2215
E02006343,1338,429,316,454,2537
E02006837,1725,617,495,661,3498
E02006344,1137,503,421,549,2610
E02006345,839,326,261,334,1760
E02006346,1465,645,481,730,3321
E02006347,782,374,269,377,1802
E02006348,1362,472,377,573,2784
E02006349,1048,297,175,295,1815
E02006350,821,237,142,207,1407
E02006351,1336,366,191,384,2277
E02006352,799,230,172,203,1404
E02006353,701,297,225,310,1533
E02006354,1295,449,361,654,2759
E02006355,1226,152,113,204,1695
E02006356,1133,252,231,382,1998
E02006357,920,352,258,308,1838
E02006358,815,224,152,227,1418
E02006359,687,319,204,323,1533
E02006360,1075,405,359,665,2504
E02006361,723,409,288,353,1773
E02006362,852,395,317,514,2078
E02006363,841,324,267,407,1839
E02006364,1017,269,185,308,1779
E02006365,884,333,304,542,2063
E02006366,1279,505,387,559,2730
E02006367,937,378,356,544,2215
E02006368,956,360,314,514,2144
E02006369,1064,461,402,569,2496
E02006370,916,361,277,384,1938
E02006371,1109,375,314,510,2308
E02006372,998,275,229,351,1853
E02006373,1086,430,330,458,2304
E02006374,1090,457,344,414,2305
E02006375,1128,372,281,399,2180
E02006376,1228,502,375,777,2882
E02006377,956,425,307,423,2111
E02006378,1159,414,292,411,2276
E02006379,941,216,150,206,1513
E02006380,1136,474,393,570,2573
E02006381,1078,439,332,462,2311
E02006382,939,258,155,243,1595
E02006383,1051,431,377,733,2592
E02006384,1250,383,306,478,2417
E02006385,1268,278,207,291,2044
E02006386,907,340,243,364,1854
E02006387,822,307,200,265,1594
E02006388,1442,388,247,329,2406
E02006389,969,373,255,362,1959
E02006390,1305,422,290,408,2425
E02006391,1060,320,204,266,1850
E02006392,1261,384,281,535,2461
E02006393,636,171,153,320,1280
E02006394,908,315,230,402,1855
E02006395,1331,372,213,386,2302
E02006396,1027,397,295,375,2094
E02006397,894,272,269,436,1871
E02006398,1317,314,255,339,2225
E02006399,1975,485,418,631,3509
E02006400,1093,326,245,380,2044
E02006401,1614,433,372,557,2976
E02006402,1532,530,385,564,3011
E02006403,803,229,164,222,1418
E02006404,994,175,158,265,1592
E02006405,1448,510,340,531,2829
E02006406,840,278,218,314,1650
E02006407,1268,417,368,523,2576
E02006408,1132,302,294,431,2159
E02006409,890,299,220,288,1697
E02006410,989,293,187,296,1765
E02006411,878,350,315,537,2080
E02006412,960,414,315,470,2159
E02006413,897,346,243,468,1954
E02006414,988,329,251,365,1933
E02006415,1043,448,424,647,2562
E02006416,1049,487,373,521,2430
E02006417,838,321,219,295,1673
E02006418,937,382,324,489,2132
E02006419,1016,235,187,411,1849
E02006420,1036,440,364,591,2431
E02006421,1157,427,311,493,2388
E02006422,924,345,264,284,1817
E02006423,1543,435,373,575,2926
E02006424,993,390,304,423,2110
E02006425,1152,305,253,326,2036
E02006426,719,313,254,333,1619
E02006427,752,306,252,327,1637
E02006429,1059,345,303,339,2046
E02006430,1357,375,275,385,2392
E02006431,1448,510,368,564,2890
E02006432,855,332,261,384,1832
E02006433,1253,523,449,746,2971
E02006434,843,307,229,371,1750
E02006435,767,337,228,289,1621
E02006436,739,295,240,346,1620
E02006437,1051,499,413,620,2583
E02006438,1251,524,415,505,2695
E02006790,1216,472,355,592,2635
E02006439,745,337,267,371,1720
E02006440,860,407,295,384,1946
E02006441,785,351,322,629,2087
E02006442,659,366,270,475,1770
E02006443,1297,323,308,441,2369
E02006444,708,354,242,377,1681
E02006445,1109,335,275,410,2129
E02006446,802,368,334,469,1973
E02006447,725,359,297,387,1768
E02006448,1147,357,253,355,2112
E02006449,824,402,320,590,2136
E02006450,899,379,303,401,1982
E02006451,2090,811,679,872,4452
E02006453,1129,552,485,725,2891
E02006454,806,336,250,569,1961
E02006455,778,257,219,364,1618
E02006839,1158,496,395,728,2777
E02006456,1114,328,267,440,2149
E02006457,1305,518,432,720,2975
E02006458,1185,472,362,566,2585
E02006459,1203,198,127,255,1783
E02006460,1264,409,249,299,2221
E02006461,981,317,262,410,1970
E02006462,1099,353,235,312,1999
E02006463,1091,297,230,400,2018
E02006464,939,315,244,376,1874
E02006465,849,318,207,341,1715
E02006466,1351,323,235,345,2254
E02006467,962,317,258,315,1852
E02006534,1200,452,380,568,2600
E02006535,986,537,388,520,2431
E02006536,1145,441,325,442,2353
E02006537,1432,498,357,638,2925
E02006538,1230,574,409,582,2795
E02006539,1134,442,389,511,2476
E02006540,911,379,329,421,2040
E02006541,1198,526,392,682,2798
E02006542,822,441,377,481,2121
E02006543,948,417,373,434,2172
E02006544,1563,776,545,803,3687
E02006545,1519,461,327,364,2671
E02006546,1742,786,620,932,4080
E02006547,939,416,298,367,2020
E02006548,1364,565,485,724,3138
E02006549,905,725,631,892,3153
E02006550,1239,790,624,937,3590
E02006551,961,1050,865,1313,4189
E02006552,988,383,273,455,2099
E02006553,1393,544,359,523,2819
E02006554,1004,610,471,638,2723
E02006555,1072,301,260,434,2067
E02006556,1494,853,678,900,3925
E02006557,960,311,216,307,1794
E02006558,1262,520,436,828,3046
E02006559,1289,977,766,1129,4161
E02006560,1497,875,723,966,4061
E02006561,785,415,317,362,1879
E02006562,833,427,345,382,1987
E02006563,850,395,328,417,1990
E02006564,1665,616,453,723,3457
E02006565,977,630,496,684,2787
E02006566,1384,601,480,820,3285
E02006567,1263,533,422,584,2802
E02006568,2114,491,388,721,3714
E02006569,1403,603,505,692,3203
E02006570,1434,500,420,742,3096
E02006571,1336,550,431,671,2988
E02006572,1855,560,418,512,3345
E02006573,2059,958,847,1136,5000
E02006574,2701,1040,823,1158,5722
E02006575,1059,247,166,262,1734
E02006576,1136,397,252,360,2145
E02006577,1159,298,213,420,2090
E02006578,1242,322,215,397,2176
E02006579,877,304,204,353,1738
E02006580,1296,318,214,472,2300
E02006581,1295,327,201,423,2246
E02006582,898,317,173,188,1576
E02006583,1231,406,303,436,2376
E02006584,1149,216,120,124,1609
E02006585,955,258,215,411,1839
E02006586,1263,225,92,78,1658
E02006587,1310,277,156,131,1874
E02006588,1439,479,335,416,2669
E02006589,1878,676,480,580,3614
E02006590,1448,472,342,515,2777
E02006591,1260,350,305,520,2435
E02006592,1041,421,300,396,2158
E02006593,1694,437,385,879,3395
E02006594,1707,461,311,452,2931
E02006595,1289,547,400,558,2794
E02006596,1717,418,274,353,2762
E02006597,1351,610,450,614,3025
E02006598,1014,361,255,346,1976
E02006599,938,729,570,706,2943
E02006600,1340,748,597,939,3624
E02006601,1557,580,516,744,3397
E02006602,996,582,431,468,2477
E02006603,1153,664,568,793,3178
E02006604,1741,582,508,738,3569
E02006605,757,351,246,360,1714
E02006606,1115,478,368,384,2345
E02006607,1034,509,400,555,2498
E02006608,933,453,319,375,2080
E02006609,877,382,316,398,1973
E02006610,894,359,314,418,1985
E02006611,1483,680,616,813,3592
E02006612,1441,503,411,774,3129
E02006613,1183,341,242,313,2079
E02006614,1631,581,435,551,3198
E02006615,962,279,189,195,1625
E02006616,1295,497,337,489,2618
E02006617,1233,433,375,573,2614
E02006618,862,368,318,545,2093
E02006619,1159,442,310,402,2313
E02006620,1267,592,499,881,3239
E02006621,1184,755,577,757,3273
E02006622,1293,534,364,559,2750
E02006623,1334,478,365,448,2625
E02006624,1197,412,294,440,2343
E02006625,1161,319,189,308,1977
E02006626,1446,346,225,273,2290
E02006627,1515,520,406,579,3020
E02006628,1489,262,196,318,2265
E02006629,1287,370,247,416,2320
E02006630,1362,494,418,917,3191
E02006631,1583,387,322,646,2938
E02006632,1393,570,433,743,3139
E02006633,1172,748,587,920,3427
E02002985,863,345,259,484,1951
E02002986,935,329,273,423,1960
E02002987,743,442,322,463,1970
E02002988,652,306,211,379,1548
E02002989,904,237,219,449,1809
E02002990,631,239,168,187,1225
E02002991,1164,501,363,613,2641
E02002992,941,295,210,335,1781
E02002993,651,175,120,199,1145
E02002994,1293,657,493,777,3220
E02002995,813,178,135,184,1310
E02002996,956,433,318,497,2204
E02002997,801,208,171,210,1390
E02002998,665,182,124,239,1210
E02002999,777,287,205,279,1548
E02003000,1412,720,599,738,3469
E02003001,746,292,198,349,1585
E02003002,732,288,223,317,1560
E02003003,796,240,190,280,1506
E02003004,927,419,297,404,2047
E02003005,801,456,368,427,2052
E02003006,1327,434,365,412,2538
E02003007,1333,539,377,562,2811
E02003008,847,244,184,247,1522
E02003009,802,324,266,397,1789
E02003010,925,304,210,290,1729
E02003011,813,374,326,424,1937
E02003012,1570,490,334,463,2857
E02003013,1915,434,336,485,3170
E02003014,798,284,161,247,1490
E02003015,1036,242,184,259,1721
E02003016,925,199,131,193,1448
E02003017,838,371,295,546,2050
E02003018,868,315,229,246,1658
E02003019,1190,450,306,463,2409
E02003020,889,402,311,634,2236
E02003021,853,192,139,228,1412
E02003022,959,352,262,445,2018
E02003023,1041,310,216,326,1893
E02003024,1259,358,242,501,2360
E02003025,821,213,193,304,1531
E02003026,1303,491,375,673,2842
E02003027,1779,342,179,248,2548
E02003028,1298,338,221,371,2228
E02003029,809,204,144,209,1366
E02003030,949,208,176,164,1497
E02003031,1565,267,133,130,2095
E02003032,994,239,176,260,1669
E02003033,1256,216,146,151,1769
E02003034,1434,176,115,140,1865
E02003036,1140,161,85,118,1504
E02003037,1324,202,132,176,1834
E02003038,850,237,191,263,1541
E02003039,1106,287,219,299,1911
E02003040,1131,228,183,323,1865
E02003041,976,272,191,235,1674
E02003043,1391,207,154,124,1876
E02003044,783,267,238,277,1565
E02003045,922,242,129,128,1421
E02003046,1163,291,193,257,1904
E02003047,1511,277,197,282,2267
E02003048,738,133,109,104,1084
E02003049,925,335,268,324,1852
E02003050,1313,260,187,331,2091
E02003051,924,169,108,133,1334
E02003052,1043,292,201,265,1801
E02003053,1033,325,200,328,1886
E02003054,899,290,183,291,1663
E02003055,1236,261,184,225,1906
E02003056,1209,273,162,216,1860
E02003057,930,310,204,360,1804
E02003058,1332,432,347,457,2568
E02003059,910,228,199,328,1665
E02003060,1368,554,519,770,3211
E02003061,793,207,158,246,1404
E02003062,803,185,140,269,1397
E02003063,1127,463,363,474,2427
E02003064,858,159,113,257,1387
E02006887,673,93,70,59,895
E02006888,560,100,54,132,846
E02006889,513,109,106,138,866
E02006890,936,140,98,161,1335
E02003065,1080,598,481,678,2837
E02003066,772,499,419,465,2155
E02003067,884,465,329,486,2164
E02003068,842,436,365,461,2104
E02003069,835,449,322,593,2199
E02003070,1563,785,589,845,3782
E02003071,1217,467,407,761,2852
E02003072,1160,720,610,960,3450
E02003073,856,515,408,416,2195
E02003074,1131,444,315,437,2327
E02003075,700,351,317,404,1772
E02003076,1611,620,463,593,3287
E02003077,936,364,363,407,2070
E02003078,1381,561,405,434,2781
E02003079,1707,525,342,365,2939
E02003080,1573,682,575,764,3594
E02003081,1723,726,561,718,3728
E02003082,1454,583,463,802,3302
E02003084,1557,479,329,622,2987
E02003085,1060,276,170,226,1732
E02003086,978,389,301,648,2316
E02003087,1875,842,639,705,4061
E02003088,1442,658,566,782,3448
E02003089,998,403,360,422,2183
E02006845,1532,364,277,370,2543
E02006846,1260,183,113,111,1667
E02003090,1108,485,483,564,2640
E02003091,861,435,336,485,2117
E02003092,1137,444,322,358,2261
E02003093,883,479,472,628,2462
E02003094,1152,459,369,464,2444
E02003095,1273,439,321,371,2404
E02003096,1011,307,240,336,1894
E02003097,1017,480,431,589,2517
E02003098,1098,220,157,160,1635
E02003099,1234,412,370,504,2520
E02003100,1674,510,458,633,3275
E02003101,1167,248,213,226,1854
E02003102,893,398,372,450,2113
E02003103,1005,330,194,170,1699
E02003104,1026,385,287,317,2015
E02003105,827,363,351,581,2122
E02003106,1380,352,294,508,2534
E02003107,1189,446,361,527,2523
E02003108,1565,589,457,638,3249
E02003109,848,367,306,484,2005
E02003110,1446,381,315,347,2489
E02003111,930,382,268,534,2114
E02003112,872,300,262,392,1826
E02003113,1640,646,521,642,3449
E02003114,955,402,292,512,2161
E02003115,1337,402,341,499,2579
E02003116,1177,349,336,529,2391
E02003117,1292,396,297,480,2465
E02003118,1630,444,343,374,2791
E02003119,1654,537,342,473,3006
E02003120,1350,537,431,655,2973
E02003121,1636,698,562,772,3668
E02003122,1141,530,457,611,2739
E02003123,1203,389,316,463,2371
E02003124,1128,311,259,333,2031
E02003125,857,331,234,285,1707
E02003126,1448,573,337,313,2671
E02003127,985,343,271,326,1925
E02003128,1297,442,339,374,2452
E02003129,929,389,272,400,1990
E02003130,1330,481,361,408,2580
E02003131,1028,443,351,369,2191
E02003132,1325,402,319,418,2464
E02003133,1054,413,346,402,2215
E02003134,935,269,178,250,1632
E02003135,959,218,158,188,1523
E02003136,1156,588,496,761,3001
E02003137,1147,462,347,709,2665
E02003138,1150,248,204,252,1854
E02003139,958,312,197,159,1626
E02003140,1140,451,315,519,2425
E02003141,1107,295,204,254,1860
E02003142,1279,376,318,365,2338
E02003143,1104,436,317,396,2253
E02003144,1067,182,132,282,1663
E02003145,957,318,207,349,1831
E02003146,1039,201,149,191,1580
E02003147,1120,291,189,230,1830
E02003148,1227,259,190,268,1944
E02003149,1013,242,193,189,1637
E02003150,1632,461,318,498,2909
E02003151,1343,639,510,878,3370
E02003152,1760,667,511,687,3625
E02003153,1212,465,392,571,2640
E02003154,1162,414,330,462,2368
E02003155,986,385,323,557,2251
E02003156,1996,544,408,423,3371
E02003157,1104,315,211,250,1880
E02003158,971,397,318,549,2235
E02003159,1027,241,170,209,1647
E02003161,1057,311,209,319,1896
E02003163,1297,792,604,950,3643
E02003164,1486,697,558,743,3484
E02003165,1152,435,332,456,2375
E02003166,1904,604,466,516,3490
E02003167,1502,586,512,949,3549
E02003168,1272,559,476,560,2867
E02003169,980,731,535,756,3002
E02003170,1391,852,710,828,3781
E02003171,1145,568,444,628,2785
E02006840,1857,683,493,690,3723
E02003212,1318,627,436,600,2981
E02003214,727,224,147,247,1345
E02003215,952,501,407,495,2355
E02003216,1135,533,435,586,2689
E02003217,870,330,235,312,1747
E02003218,752,293,197,245,1487
E02003219,1430,456,323,399,2608
E02003220,1097,459,410,783,2749
E02003221,619,231,161,211,1222
E02003222,901,215,104,116,1336
E02003223,1111,332,206,317,1966
E02003224,1126,523,432,621,2702
E02003225,911,289,145,165,1510
E02003226,854,191,133,148,1326
E02003227,854,195,131,206,1386
E02003228,889,268,201,340,1698
E02003229,911,208,102,92,1313
E02003230,752,163,134,203,1252
E02003231,1019,300,225,343,1887
E02003232,985,298,193,305,1781
E02003233,1354,437,266,321,2378
E02003234,1312,527,334,435,2608
E02003235,1103,449,342,617,2511
E02003236,1948,679,608,902,4137
E02006847,1136,215,149,117,1617
E02006848,877,84,74,83,1118
E02006849,1256,304,191,215,1966
E02003892,1283,570,423,406,2682
E02003893,1237,510,403,387,2537
E02003894,1460,566,423,556,3005
E02003895,1575,588,401,499,3063
E02003896,962,385,305,426,2078
E02003897,1022,439,302,279,2042
E02003898,1283,568,419,441,2711
E02003899,1085,449,332,381,2247
E02003900,1370,444,381,444,2639
E02003901,1286,739,508,660,3193
E02003902,1061,319,267,356,2003
E02003903,1247,510,367,404,2528
E02003904,809,493,303,446,2051
E02003905,1087,442,265,295,2089
E02003906,1019,436,338,462,2255
E02003907,1319,547,441,523,2830
E02003908,1416,497,355,547,2815
E02003909,2366,582,422,647,4017
E02003910,1132,367,292,495,2286
E02003911,1477,738,592,706,3513
E02003912,1211,683,491,682,3067
E02003913,857,520,422,508,2307
E02003914,793,333,276,312,1714
E02003915,740,368,263,359,1730
E02003916,587,415,290,533,1825
E02003917,983,462,363,475,2283
E02003918,1135,475,360,440,2410
E02003919,1056,374,259,355,2044
E02003920,1218,448,343,430,2439
E02003921,956,440,328,407,2131
E02003922,1273,449,338,362,2422
E02003923,1251,460,335,375,2421
E02003924,970,497,418,611,2496
E02003925,1015,420,281,381,2097
E02003926,1136,558,367,427,2488
E02003927,1260,742,551,654,3207
E02003928,1847,641,518,686,3692
E02003929,1102,599,407,487,2595
E02003930,1374,787,555,673,3389
E02003931,1311,737,573,834,3455
E02003932,1010,542,389,473,2414
E02003933,874,567,422,452,2315
E02003934,861,553,354,410,2178
E02003935,1482,481,400,590,2953
E02003936,1345,751,536,581,3213
E02003937,653,430,310,447,1840
E02003938,728,430,355,391,1904
E02003939,857,508,394,595,2354
E02003940,937,519,368,440,2264
E02003941,1203,456,333,484,2476
E02003942,1121,376,308,373,2178
E02003943,1098,517,378,480,2473
E02003944,1633,728,546,652,3559
E02003945,958,537,403,476,2374
E02003946,1386,697,522,616,3221
E02003947,959,554,394,445,2352
E02003948,1193,557,446,603,2799
E02003949,907,420,307,460,2094
E02003950,753,403,286,333,1775
E02003951,824,521,400,495,2240
E02003952,1212,531,346,434,2523
E02003953,1321,649,466,524,2960
E02003954,923,381,267,432,2003
E02003955,1228,590,431,588,2837
E02003956,968,432,306,334,2040
E02003957,1416,711,538,538,3203
E02003958,986,471,342,366,2165
E02003959,979,399,293,411,2082
E02003960,887,494,397,499,2277
E02003961,1483,692,506,659,3340
E02003962,1078,447,282,365,2172
E02003963,1341,575,488,725,3129
E02003964,1134,743,605,680,3162
E02006781,453,140,125,166,884
E02006634,996,586,427,559,2568
E02006635,873,478,459,804,2614
E02006636,781,491,390,488,2150
E02006637,1556,592,460,616,3224
E02006638,905,484,401,617,2407
E02006639,1123,637,508,510,2778
E02006640,884,497,335,431,2147
E02006641,1084,504,357,518,2463
E02006642,622,376,265,289,1552
E02006643,1575,385,220,266,2446
E02006644,793,517,337,383,2030
E02006645,1498,443,331,418,2690
E02006646,1030,379,273,486,2168
E02006647,1112,466,331,350,2259
E02006648,972,396,306,412,2086
E02006649,960,410,301,452,2123
E02006650,1371,725,563,632,3291
E02006651,968,476,370,389,2203
E02006652,1120,365,294,420,2199
E02006653,1262,506,348,444,2560
E02006654,1139,475,392,734,2740
E02006655,748,516,365,543,2172
E02006656,924,277,156,193,1550
E02006657,1032,462,332,397,2223
E02006658,750,488,372,474,2084
E02006659,945,443,350,423,2161
E02006660,1564,824,623,855,3866
E02006661,784,223,175,201,1383
E02006662,749,353,250,291,1643
E02006663,1541,523,385,632,3081
E02006664,990,443,335,421,2189
E02006665,874,579,479,603,2535
E02006666,1111,341,235,368,2055
E02006667,1268,255,161,203,1887
E02006668,1142,390,341,436,2309
E02006669,1579,745,561,854,3739
E02006670,1296,327,240,346,2209
E02006671,1123,339,272,479,2213
E02006672,1505,476,341,625,2947
E02006673,896,355,302,545,2098
E02006674,1180,300,228,350,2058
E02006675,1338,572,432,558,2900
E02006676,801,517,348,500,2166
E02006677,1328,593,444,678,3043
E02006678,875,424,370,394,2063
E02006679,1412,670,523,669,3274
E02006680,897,442,350,661,2350
E02006681,805,468,377,481,2131
E02006682,1244,729,567,883,3423
E02006683,1042,400,318,372,2132
E02006684,802,331,253,369,1755
E02006685,1191,526,356,549,2622
E02006686,653,305,219,295,1472
E02006687,1008,344,252,255,1859
E02006688,688,290,212,298,1488
E02006689,803,476,396,459,2134
E02006690,873,541,386,481,2281
E02006691,1785,643,526,736,3690
E02006692,561,284,216,350,1411
E02006693,804,380,299,311,1794
E02006694,704,429,373,540,2046
E02006695,764,522,393,574,2253
E02003172,991,393,277,397,2058
E02003173,1144,454,343,568,2509
E02003174,1283,503,379,595,2760
E02003175,1535,397,322,382,2636
E02003176,1100,273,217,267,1857
E02003177,1312,351,245,383,2291
E02003178,1289,415,310,436,2450
E02003179,1244,350,260,400,2254
E02003180,1106,255,145,261,1767
E02003181,1276,386,252,389,2303
E02003182,1266,373,257,367,2263
E02003183,947,379,296,433,2055
E02003184,959,189,132,243,1523
E02003185,1341,353,231,331,2256
E02003186,1237,240,158,186,1821
E02003187,1459,371,260,361,2451
E02003188,1288,388,283,526,2485
E02003189,1546,512,350,726,3134
E02003190,1500,318,176,342,2336
E02003191,1479,647,556,862,3544
E02003192,1311,392,335,541,2579
E02003194,1160,502,446,488,2596
E02003195,1072,278,202,273,1825
E02003196,1974,743,569,1115,4401
E02003197,1240,435,217,277,2169
E02003198,1258,336,273,308,2175
E02003199,1675,529,389,627,3220
E02003200,1739,506,402,538,3185
E02003201,1944,464,393,470,3271
E02003202,910,309,231,323,1773
E02003203,1304,322,217,288,2131
E02003204,1633,462,371,613,3079
E02003205,1566,543,365,503,2977
E02003206,1758,506,364,509,3137
E02003207,976,337,286,300,1899
E02003208,2071,611,444,854,3980
E02003209,1026,419,297,342,2084
E02003210,1615,607,499,871,3592
E02003211,1287,822,746,1373,4228
E02004236,1080,518,378,510,2486
E02004237,1436,522,404,613,2975
E02004238,1086,799,672,1197,3754
E02004239,933,574,458,695,2660
E02004240,957,272,210,257,1696
E02004241,1442,597,494,912,3445
E02004242,1049,633,581,788,3051
E02006883,749,253,269,578,1849
E02006885,1043,418,332,593,2386
E02004243,1055,480,313,361,2209
E02004244,1388,510,433,676,3007
E02004245,1321,529,393,621,2864
E02004246,1242,876,634,868,3620
E02004247,1148,435,315,340,2238
E02004248,1279,769,670,1086,3804
E02004249,999,468,322,401,2190
E02004250,1218,715,572,1058,3563
E02004251,1119,521,409,574,2623
E02004252,1313,519,432,754,3018
E02004253,1521,842,754,1298,4415
E02004254,2023,693,510,621,3847
E02004255,898,518,420,728,2564
E02004256,1192,630,505,647,2974
E02004257,1065,519,400,671,2655
E02004258,1502,858,659,1018,4037
E02004259,849,588,440,570,2447
E02004260,1045,548,412,442,2447
E02004261,1312,658,447,742,3159
E02004262,1038,675,442,497,2652
E02004263,868,438,326,384,2016
E02004264,1318,587,428,558,2891
E02004265,1271,711,549,768,3299
E02004266,1155,506,402,449,2512
E02004267,731,503,367,463,2064
E02004268,1321,848,698,977,3844
E02004269,1077,676,648,1113,3514
E02004270,1148,720,563,738,3169
E02004271,1505,892,700,879,3976
E02004272,1846,907,728,850,4331
E02004273,968,706,536,770,2980
E02004274,973,533,404,565,2475
E02004275,1142,689,508,616,2955
E02004276,860,530,415,576,2381
E02004277,2154,841,688,1352,5035
E02004278,1535,596,464,619,3214
E02004279,1257,661,478,559,2955
E02004280,1283,597,490,634,3004
E02004281,1349,393,287,318,2347
E02004282,1465,911,705,1032,4113
E02004283,1581,576,485,643,3285
E02004284,1675,607,468,686,3436
E02004285,1312,441,322,493,2568
E02004286,819,335,211,330,1695
E02004287,883,419,277,336,1915
E02004288,901,295,199,219,1614
E02004289,1284,502,403,399,2588
E02004129,770,489,405,466,2130
E02004130,935,448,386,654,2423
E02004131,870,372,291,479,2012
E02004132,1378,619,460,511,2968
E02004133,1444,727,602,788,3561
E02004134,1913,519,373,544,3349
E02004135,1153,779,637,827,3396
E02004136,1575,715,513,791,3594
E02004137,849,537,419,530,2335
E02004138,1142,850,690,1110,3792
E02004139,1392,599,558,746,3295
E02004140,901,571,489,1042,3003
E02004141,1059,490,357,491,2397
E02004142,929,415,330,436,2110
E02004143,1086,496,401,500,2483
E02004144,1207,546,471,578,2802
E02004145,1065,637,562,884,3148
E02004146,1326,473,312,398,2509
E02004147,1186,394,240,341,2161
E02004148,1242,702,621,1150,3715
E02004149,1007,446,304,417,2174
E02004150,909,239,201,262,1611
E02004151,1394,460,377,622,2853
E02004152,616,151,144,173,1084
E02004153,1126,328,236,237,1927
E02004154,1261,238,158,315,1972
E02004155,1281,384,271,403,2339
E02004156,1006,314,214,349,1883
E02004157,1256,274,214,348,2092
E02004158,1192,305,195,330,2022
E02004159,1983,583,399,476,3441
E02004160,1154,423,339,587,2503
E02004161,1531,331,271,472,2605
E02004162,947,346,302,496,2091
E02004163,1253,579,441,675,2948
E02004164,788,533,379,500,2200
E02004165,986,588,486,709,2769
E02004166,944,455,353,399,2151
E02004167,796,315,283,391,1785
E02004168,705,340,250,363,1658
E02004169,824,450,342,471,2087
E02004170,1084,452,349,448,2333
E02004171,1073,529,419,494,2515
E02004172,898,489,335,385,2107
E02004173,998,541,358,472,2369
E02004174,981,481,362,543,2367
E02004175,878,313,243,326,1760
E02004176,817,498,337,362,2014
E02004177,927,414,262,344,1947
E02004178,695,422,317,344,1778
E02004179,1185,567,490,712,2954
E02004180,992,446,373,426,2237
E02004181,1015,347,247,398,2007
E02004182,973,278,243,374,1868
E02004183,841,426,392,534,2193
E02004184,1379,414,254,375,2422
E02004185,994,534,504,652,2684
E02004186,1513,563,474,593,3143
E02004187,1407,757,558,756,3478
E02004188,871,542,447,568,2428
E02004189,1005,353,242,310,1910
E02004190,1249,665,423,530,2867
E02004191,1378,573,450,605,3006
E02004192,1158,668,483,533,2842
E02004193,1786,686,494,623,3589
E02004194,992,488,336,449,2265
E02004195,672,402,322,418,1814
E02004196,1251,677,438,544,2910
E02004197,1234,593,508,624,2959
E02004198,823,435,349,578,2185
E02004199,708,600,434,598,2340
E02004200,638,459,361,482,1940
E02004201,859,467,388,444,2158
E02004202,1140,556,435,532,2663
E02004203,1059,545,329,475,2408
E02004204,1721,627,545,683,3576
E02004205,1330,639,483,522,2974
E02004206,1008,589,504,719,2820
E02004207,1068,448,387,464,2367
E02004208,1001,747,520,618,2886
E02004209,1430,526,436,559,2951
E02004210,899,415,324,576,2214
E02004211,967,689,451,700,2807
E02004212,1038,371,237,340,1986
E02004213,1455,409,261,356,2481
E02004214,955,280,241,297,1773
E02004215,1040,335,246,466,2087
E02004216,1016,374,321,407,2118
E02004217,1131,514,424,491,2560
E02004218,1183,474,363,443,2463
E02004219,1006,449,410,480,2345
E02004220,940,527,456,530,2453
E02004221,940,616,496,717,2769
E02004222,919,375,252,330,1876
E02004223,2117,709,492,559,3877
E02004224,755,539,397,507,2198
E02004225,856,387,286,442,1971
E02004226,941,610,470,557,2578
E02004227,1201,760,540,639,3140
E02004228,895,623,469,484,2471
E02004229,1632,635,491,619,3377
E02004230,1669,485,397,553,3104
E02004231,1268,519,383,448,2618
E02004232,1139,509,383,449,2480
E02004233,2240,939,763,1103,5045
E02004234,1081,547,407,499,2534
E02004235,1139,602,426,532,2699
E02004600,1024,305,210,255,1794
E02004601,875,438,354,561,2228
E02004602,1145,277,204,283,1909
E02004603,1017,241,181,226,1665
E02004604,1359,214,186,276,2035
E02004605,996,224,190,213,1623
E02004606,1646,348,243,496,2733
E02004607,1442,420,290,434,2586
E02004608,1381,419,347,611,2758
E02004609,1102,381,346,501,2330
E02004610,1054,512,390,687,2643
E02004611,1768,524,402,700,3394
E02004612,1392,524,434,660,3010
E02004613,1157,389,351,539,2436
E02004614,908,360,233,474,1975
E02004615,1175,659,590,774,3198
E02004616,1452,682,573,897,3604
E02004617,1199,594,491,616,2900
E02004618,950,530,326,375,2181
E02004619,724,505,417,468,2114
E02004620,808,510,331,393,2042
E02004621,507,373,310,716,1906
E02004622,646,388,322,478,1834
E02004623,883,710,505,637,2735
E02004624,620,409,349,411,1789
E02004625,937,657,504,651,2749
E02004626,1347,660,514,649,3170
E02004627,921,399,344,429,2093
E02004628,1034,528,390,431,2383
E02004629,1893,736,535,688,3852
E02004630,937,500,359,473,2269
E02004631,443,262,207,229,1141
E02004632,1393,698,535,709,3335
E02004633,1118,592,400,467,2577
E02004634,1308,698,536,708,3250
E02004635,148,125,79,72,424
E02004636,1404,451,361,456,2672
E02004637,1860,393,303,583,3139
E02004638,1068,323,230,341,1962
E02004639,1482,338,300,503,2623
E02004640,1135,163,153,195,1646
E02004641,1279,528,519,698,3024
E02004642,2190,500,375,392,3457
E02004643,1246,201,145,227,1819
E02004644,1654,315,244,331,2544
E02004645,1756,490,347,393,2986
E02004646,1541,411,295,380,2627
E02004647,1156,343,254,426,2179
E02004648,1064,434,380,412,2290
E02004649,1284,218,147,145,1794
E02004650,1919,349,247,333,2848
E02004651,1570,479,313,361,2723
E02004652,959,529,439,618,2545
E02004653,1013,495,343,476,2327
E02004654,1591,701,500,672,3464
E02004655,1128,439,316,453,2336
E02004656,1518,566,351,545,2980
E02004657,900,404,311,364,1979
E02004658,795,409,293,375,1872
E02004659,1067,491,370,481,2409
E02004660,888,563,447,679,2577
E02004661,1285,627,443,598,2953
E02004662,957,412,289,384,2042
E02004663,925,445,294,396,2060
E02004664,995,344,269,448,2056
E02004665,1134,562,464,566,2726
E02004666,1788,546,418,480,3232
E02004667,1860,774,584,820,4038
E02004668,1361,816,591,681,3449
E02004669,1115,551,395,504,2565
E02004670,2190,762,679,1044,4675
E02004671,1348,498,357,393,2596
E02004672,2259,642,529,788,4218
E02004673,1257,411,342,513,2523
E02004674,1865,495,377,528,3265
E02006047,1452,643,451,514,3060
E02006048,1082,484,332,384,2282
E02006049,1466,573,434,528,3001
E02006050,1598,388,275,452,2713
E02006051,1403,579,449,660,3091
E02006052,1268,486,420,549,2723
E02006053,2141,522,381,474,3518
E02006054,1565,610,487,821,3483
E02006055,1277,447,303,389,2416
E02006056,1130,552,385,480,2547
E02006057,1209,505,335,457,2506
E02006058,1241,523,380,508,2652
E02006059,1071,542,352,462,2427
E02006060,1134,417,335,566,2452
E02006061,1418,636,509,688,3251
E02006062,1857,926,708,947,4438
E02006063,980,565,409,471,2425
E02006064,1141,657,552,873,3223
E02006065,1614,540,459,457,3070
E02006066,1355,633,472,535,2995
E02006067,1209,537,417,563,2726
E02006068,888,329,209,316,1742
E02006069,1188,403,232,402,2225
E02006070,1024,417,309,377,2127
E02006071,1324,561,395,603,2883
E02006072,1441,763,555,659,3418
E02006073,931,320,220,329,1800
E02006074,1528,581,421,510,3040
E02006075,618,309,251,307,1485
E02006076,1789,702,563,769,3823
E02006077,996,477,358,560,2391
E02006078,967,524,324,452,2267
E02006079,1371,522,397,521,2811
E02006080,1055,384,295,378,2112
E02006081,873,462,351,441,2127
E02006082,1190,535,412,415,2552
E02006083,967,465,323,408,2163
E02006084,1356,611,457,628,3052
E02006085,1208,450,299,341,2298
E02006086,1179,425,326,404,2334
E02006087,880,240,210,312,1642
E02006088,1306,325,223,361,2215
E02006089,1191,246,183,329,1949
E02006090,1149,351,267,473,2240
E02006091,1715,789,622,703,3829
E02006092,1079,479,320,358,2236
E02006093,1370,680,546,758,3354
E02006094,813,447,328,432,2020
E02006095,1451,633,505,658,3247
E02006096,1087,502,340,429,2358
E02006097,926,375,303,538,2142
E02006098,1215,680,509,557,2961
E02006099,1464,461,335,404,2664
E02006100,1423,440,361,486,2710
E02006101,942,381,339,424,2086
E02006102,1317,353,266,417,2353
E02006103,1268,630,481,602,2981
E02006104,1860,431,350,394,3035
E02006105,2099,430,327,489,3345
E02006106,2231,466,345,505,3547
E02006107,1580,393,260,375,2608
E02006108,1626,499,446,971,3542
E02006109,1755,550,477,710,3492
E02006110,1506,522,350,541,2919
E02006111,1516,875,673,888,3952
E02006112,1494,583,422,630,3129
E02006113,1167,547,475,834,3023
E02006114,969,624,471,728,2792
E02006115,1321,645,524,624,3114
E02006116,1399,776,593,709,3477
E02006117,874,519,413,521,2327
E02002905,1117,493,386,409,2405
E02002906,949,343,254,446,1992
E02002907,1190,409,321,465,2385
E02002908,1613,773,566,653,3605
E02002909,2003,909,597,810,4319
E02002910,1276,567,467,643,2953
E02002911,1652,726,494,701,3573
E02002912,1226,470,335,445,2476
E02002913,1146,526,401,468,2541
E02002914,1470,479,387,525,2861
E02002915,1361,400,400,661,2822
E02002916,1618,422,281,429,2750
E02002917,1058,338,258,416,2070
E02002918,1070,366,292,543,2271
E02002919,1421,413,298,419,2551
E02002920,952,341,317,334,1944
E02002921,1066,296,173,232,1767
E02002922,930,502,357,481,2270
E02002923,1383,733,606,892,3614
E02002924,635,441,294,431,1801
E02002925,1496,696,517,679,3388
E02002926,1377,753,608,962,3700
E02002927,1387,792,683,743,3605
E02002928,1023,415,296,327,2061
E02002929,1086,429,362,404,2281
E02002930,1062,413,326,418,2219
E02002931,1119,382,319,335,2155
E02002932,1151,335,241,299,2026
E02002933,1464,440,363,474,2741
E02002934,1169,315,201,222,1907
E02002935,943,391,274,364,1972
E02002936,1250,278,191,229,1948
E02002937,1790,656,511,587,3544
E02002938,975,291,205,255,1726
E02002939,1187,411,328,486,2412
E02002940,889,310,228,312,1739
E02002941,1492,496,421,503,2912
E02002942,1094,321,197,266,1878
E02002943,2294,412,268,321,3295
E02002944,1042,305,219,223,1789
E02002945,1065,396,288,233,1982
E02002946,1167,397,248,320,2132
E02002947,769,296,213,202,1480
E02002948,741,231,151,161,1284
E02002949,876,354,227,294,1751
E02002950,588,285,218,264,1355
E02002951,1291,523,305,422,2541
E02002952,1024,291,230,335,1880
E02002953,1088,437,364,387,2276
E02002954,1369,386,317,407,2479
E02002955,689,191,160,198,1238
E02002956,1262,388,269,349,2268
E02002957,1676,609,495,681,3461
E02002958,1256,342,271,419,2288
E02002959,919,274,215,304,1712
E02002960,996,313,232,271,1812
E02002961,714,182,167,224,1287
E02002962,1111,300,252,338,2001
E02002963,862,233,179,220,1494
E02002964,1286,577,415,548,2826
E02002965,769,155,114,141,1179
E02002966,792,247,151,212,1402
E02002967,1150,297,188,342,1977
E02002968,1850,371,235,378,2834
E02002969,1310,313,228,311,2162
E02002970,1074,333,261,260,1928
E02002971,711,301,171,139,1322
E02002972,857,331,225,232,1645
E02002973,1336,302,218,281,2137
E02002974,1015,395,288,450,2148
E02002975,1269,380,286,294,2229
E02002976,844,320,233,278,1675
E02002977,859,356,354,463,2032
E02002978,864,252,189,263,1568
E02002979,547,180,147,172,1046
E02002980,890,411,358,548,2207
E02002981,1097,307,199,277,1880
E02002982,1170,274,182,227,1853
E02002983,908,347,279,265,1799
E02002984,945,418,289,340,1992
E02006008,1399,517,421,545,2882
E02006009,846,406,359,596,2207
E02006010,1776,920,623,736,4055
E02006011,854,425,374,561,2214
E02006012,1045,502,390,525,2462
E02006013,1121,616,522,625,2884
E02006014,1433,769,630,651,3483
E02006015,1553,619,501,713,3386
E02006016,1169,613,471,471,2724
E02006017,1191,477,345,490,2503
E02006018,1678,742,636,773,3829
E02006019,872,399,325,520,2116
E02006020,995,364,260,324,1943
E02006021,1425,560,412,462,2859
E02006022,908,352,276,335,1871
E02006023,1230,335,245,349,2159
E02006024,1996,513,385,521,3415
E02006025,1715,541,478,699,3433
E02006026,1384,529,383,393,2689
E02006027,1010,356,280,383,2029
E02006028,1538,618,508,671,3335
E02006029,1200,327,253,377,2157
E02006030,1280,339,243,324,2186
E02006031,1216,324,277,390,2207
E02006032,1554,433,371,396,2754
E02006033,1381,493,417,668,2959
E02006034,2168,594,416,558,3736
E02006035,970,521,392,561,2444
E02006036,1189,391,304,431,2315
E02006037,1725,554,417,651,3347
E02006038,1540,552,456,537,3085
E02006039,1339,611,488,598,3036
E02006040,1118,530,438,437,2523
E02006041,800,437,289,372,1898
E02006042,890,576,449,747,2662
E02006043,980,478,400,450,2308
E02006044,812,541,397,421,2171
E02006045,1587,811,673,1122,4193
E02006046,1622,662,614,645,3543
E02006118,1106,550,457,446,2559
E02006119,991,406,282,446,2125
E02006120,1203,461,363,450,2477
E02006121,909,296,205,210,1620
E02006122,1166,322,259,279,2026
E02006123,1009,308,216,273,1806
E02006124,959,326,234,297,1816
E02006125,1108,402,334,321,2165
E02006126,1254,428,320,375,2377
E02006127,1080,232,122,167,1601
E02006128,1266,658,470,699,3093
E02006129,1048,320,304,366,2038
E02006130,1217,411,339,372,2339
E02006131,1307,545,379,515,2746
E02006132,1141,342,275,321,2079
E02006133,1305,341,260,387,2293
E02006134,2002,633,523,693,3851
E02006135,1567,499,379,501,2946
E02006136,1522,588,538,553,3201
E02006137,1435,360,303,428,2526
E02006138,841,180,112,148,1281
E02006139,770,228,141,218,1357
E02006140,1302,434,353,445,2534
E02006141,1071,254,200,290,1815
E02006142,908,355,227,281,1771
E02006143,1310,378,268,330,2286
E02006144,1045,375,263,383,2066
E02006145,1037,418,319,380,2154
E02006146,1235,505,419,416,2575
E02006147,1171,513,387,459,2530
E02006148,985,568,492,414,2459
E02006149,1151,476,467,766,2860
E02006150,1519,894,660,822,3895
E02006151,1308,523,497,459,2787
E02006152,1196,637,474,586,2893
E02006153,1307,456,397,439,2599
E02006154,1334,808,766,734,3642
E02006155,651,260,223,224,1358
E02006156,1374,569,513,688,3144
E02006157,962,391,301,360,2014
E02006158,1280,568,451,417,2716
E02006159,817,331,265,333,1746
E02006160,1237,549,375,433,2594
E02006161,1054,390,315,378,2137
E02006162,1254,585,379,504,2722
E02006163,1109,333,279,396,2117
E02006164,910,294,210,334,1748
E02006165,1013,406,257,422,2098
E02006166,1183,424,299,426,2332
E02006167,1270,358,289,373,2290
E02006168,1112,323,242,554,2231
E02006169,1037,282,219,246,1784
E02006170,895,396,278,412,1981
E02006171,1450,504,386,626,2966
E02006172,1791,657,531,799,3778
E02006173,1125,588,403,470,2586
E02006174,1794,790,627,678,3889
E02006175,904,298,262,251,1715
E02006176,1142,564,466,548,2720
E02006177,1736,652,565,574,3527
E02006178,1376,525,416,407,2724
E02006179,1114,442,404,428,2388
E02006180,1153,347,308,519,2327
E02006181,816,350,274,442,1882
E02006182,1102,454,458,604,2618
E02006183,1223,483,327,453,2486
E02006184,754,322,181,223,1480
E02006185,1214,417,373,576,2580
E02006186,2007,827,634,1048,4516
E02006187,988,595,525,615,2723
E02006188,989,418,386,485,2278
E02006189,1145,539,417,593,2694
E02006190,1764,578,460,743,3545
E02006191,1483,575,440,434,2932
E02006192,1622,559,461,536,3178
E02006193,1415,402,390,468,2675
E02006194,1404,372,306,494,2576
E02006195,1409,716,545,577,3247
E02006196,1151,231,187,193,1762
E02006197,1284,282,249,392,2207
E02006198,1614,476,348,470,2908
E02006199,1689,525,434,596,3244
E02006200,1360,337,267,342,2306
E02006201,2146,892,747,951,4736
E02006202,1520,704,535,599,3358
E02006203,1361,395,290,319,2365
E02006204,988,482,331,450,2251
E02006205,1171,677,463,525,2836
E02006206,1240,321,200,326,2087
E02006207,1020,606,486,523,2635
E02006208,1019,433,282,432,2166
E02006209,1434,765,588,761,3548
E02006210,721,374,296,306,1697
E02006211,1117,454,401,609,2581
E02006212,1209,580,455,616,2860
E02006213,1003,438,353,377,2171
E02006214,932,400,346,378,2056
E02006215,1210,568,452,544,2774
E02006216,1239,663,463,500,2865
E02006217,1467,608,494,674,3243
E02006218,1071,420,375,481,2347
E02006219,1140,439,296,237,2112
E02006220,1030,409,390,451,2280
E02006221,766,275,165,159,1365
E02006222,845,387,251,276,1759
E02006223,734,290,174,130,1328
E02006224,1056,330,194,161,1741
E02006225,1057,468,315,361,2201
E02006226,1188,410,260,296,2154
E02006468,1517,649,504,572,3242
E02006469,1112,427,329,378,2246
E02006470,1377,665,515,618,3175
E02006471,1278,509,379,352,2518
E02006472,1249,543,410,475,2677
E02006473,2141,653,455,704,3953
E02006474,1077,375,280,365,2097
E02006475,1279,505,357,519,2660
E02006476,1052,301,218,254,1825
E02006477,1196,475,328,425,2424
E02006478,1203,343,220,178,1944
E02006479,1081,295,264,277,1917
E02006480,1045,343,227,224,1839
E02006481,910,351,308,258,1827
E02006482,1120,380,242,253,1995
E02006483,925,334,229,378,1866
E02006484,994,302,252,366,1914
E02006485,1081,526,383,444,2434
E02006486,1229,385,292,363,2269
E02006487,1062,408,341,362,2173
E02006488,982,473,454,595,2504
E02006489,1172,337,275,231,2015
E02006490,1214,404,263,392,2273
E02006806,1370,367,317,433,2487
E02006492,2128,621,500,627,3876
E02006493,1438,373,233,219,2263
E02006494,881,254,218,354,1707
E02006495,1436,505,455,501,2897
E02006496,754,182,113,161,1210
E02006497,908,230,178,250,1566
E02006498,1914,601,395,421,3331
E02006499,961,295,262,370,1888
E02006500,781,289,297,373,1740
E02006501,1463,471,489,608,3031
E02006502,1679,750,661,1025,4115
E02006503,1532,601,533,690,3356
E02006504,1068,402,362,425,2257
E02006505,1171,558,481,652,2862
E02006506,1010,388,325,435,2158
E02006507,1756,607,484,618,3465
E02006508,1735,611,570,588,3504
E02006509,1075,417,363,494,2349
E02006510,1151,538,462,587,2738
E02006511,1560,666,514,698,3438
E02006512,1921,662,516,704,3803
E02006513,1299,495,407,698,2899
E02006514,1532,638,506,851,3527
E02006515,1727,732,534,663,3656
E02006516,1531,611,467,539,3148
E02006517,1293,579,444,488,2804
E02006518,1436,756,589,805,3586
E02006519,1445,501,443,645,3034
E02006520,1628,497,421,599,3145
E02006521,1452,490,410,703,3055
E02006522,1073,402,303,330,2108
E02006523,1722,634,497,744,3597
E02006524,901,249,187,271,1608
E02006525,1908,627,511,824,3870
E02006526,1609,472,372,424,2877
E02006527,1376,456,344,428,2604
E02006528,1389,381,279,343,2392
E02006529,1895,513,362,508,3278
E02006530,1878,542,458,624,3502
E02006531,1225,236,181,238,1880
E02006532,1681,505,391,428,3005
E02006533,1593,387,330,486,2796
E02006696,1127,378,379,563,2447
E02006697,1096,484,380,541,2501
E02006698,1029,374,254,470,2127
E02006699,754,393,338,462,1947
E02006700,931,375,386,535,2227
E02006701,1136,401,330,446,2313
E02006702,1009,333,239,325,1906
E02006703,1356,458,357,483,2654
E02006704,1145,429,364,505,2443
E02006705,1231,357,298,390,2276
E02006706,1035,404,345,632,2416
E02006707,1025,399,272,377,2073
E02006708,1098,322,221,296,1937
E02006709,1316,469,333,344,2462
E02006710,1772,668,522,616,3578
E02006711,1944,602,454,630,3630
E02006712,1669,580,430,568,3247
E02006713,1050,416,368,608,2442
E02006714,957,488,370,509,2324
E02006715,1404,516,341,435,2696
E02006716,1050,320,245,331,1946
E02006717,1121,488,381,505,2495
E02006718,1006,511,377,624,2518
E02006719,1137,625,437,704,2903
E02006720,1139,529,420,603,2691
E02006721,941,489,297,313,2040
E02006722,587,245,97,98,1027
E02006723,1059,300,213,319,1891
E02006724,659,197,133,181,1170
E02006725,660,309,163,157,1289
E02006726,845,283,211,241,1580
E02006727,843,383,282,323,1831
E02006728,1173,412,328,474,2387
E02006729,1023,486,273,201,1983
E02006730,675,229,175,143,1222
E02006731,811,327,262,255,1655
E02006732,1082,412,301,373,2168
E02006733,805,393,289,275,1762
E02006734,1480,475,434,587,2976
E02006735,948,160,137,209,1454
E02006736,1289,214,160,164,1827
E02006737,1460,420,313,337,2530
E02006738,1562,281,213,263,2319
E02006739,1022,273,274,390,1959
E02006740,1207,283,198,287,1975
E02006741,1300,227,131,220,1878
E02006742,1674,367,292,393,2726
E02006743,1317,306,168,191,1982
E02006744,1243,244,173,263,1923
E02006745,1718,555,372,616,3261
E02006746,1614,503,319,438,2874
E02006747,1041,303,215,271,1830
E02006748,1475,506,358,506,2845
E02006749,930,286,174,185,1575
E02006750,914,382,320,583,2199
E02006751,1037,406,305,420,2168
E02006752,1418,513,355,439,2725
E02006753,1620,477,352,442,2891
E02006754,1013,450,338,335,2136
E02006755,900,439,400,471,2210
E02006756,1089,351,237,292,1969
E02006757,1154,571,456,612,2793
E02006758,935,416,293,289,1933
E02006759,1160,612,546,742,3060
E02006760,1505,621,501,642,3269
E02006761,784,246,185,318,1533
E02006762,1001,396,312,436,2145
E02006763,1229,479,305,470,2483
E02006764,860,266,182,219,1527
E02006765,999,556,447,678,2680
E02006766,1350,700,491,563,3104
E02006767,1499,704,595,692,3490
E02006768,1045,488,470,444,2447
E02006769,1088,413,357,470,2328
E02006770,1087,281,234,241,1843
E02006771,1333,568,443,468,2812
E02006772,1055,451,358,498,2362
E02006773,1225,603,461,580,2869
E02006774,1108,399,280,319,2106
E02006775,868,271,204,227,1570
E02006776,972,509,294,306,2081
E02006777,1423,663,536,608,3230
E02006778,1028,528,414,585,2555
E02006779,1162,593,421,509,2685
E02006780,898,493,430,463,2284
E02001827,1160,358,303,493,2314
E02001828,1309,419,413,654,2795
E02001829,1617,468,392,554,3031
E02001830,1896,650,511,792,3849
E02001831,1913,436,346,477,3172
E02001832,1494,472,354,475,2795
E02001833,978,298,242,319,1837
E02001834,788,208,157,214,1367
E02001835,1556,407,305,527,2795
E02001836,1668,491,415,573,3147
E02001837,1202,293,226,269,1990
E02001838,1473,466,310,453,2702
E02001839,883,279,206,345,1713
E02001840,1136,258,219,300,1913
E02001841,1255,505,348,447,2555
E02001842,897,290,266,338,1791
E02001843,875,274,245,324,1718
E02001844,1792,502,426,749,3469
E02001845,792,215,213,173,1393
E02001846,1132,240,217,226,1815
E02001847,950,377,246,314,1887
E02001848,680,200,137,264,1281
E02001849,1077,209,148,193,1627
E02001850,853,269,237,318,1677
E02001851,1431,358,252,369,2410
E02001852,916,234,156,241,1547
E02001854,1233,286,246,352,2117
E02001855,1905,320,289,470,2984
E02001856,930,195,132,190,1447
E02001857,1563,315,193,308,2379
E02001858,982,180,136,215,1513
E02001859,653,158,130,228,1169
E02001860,716,136,115,196,1163
E02001861,688,146,134,190,1158
E02001862,1049,175,131,265,1620
E02001863,510,125,86,161,882
E02001864,474,123,95,128,820
E02001865,1010,184,147,204,1545
E02001866,557,115,83,165,920
E02001867,428,99,89,144,760
E02001868,996,240,187,328,1751
E02001869,460,102,72,110,744
E02001870,1150,218,165,299,1832
E02001871,1003,337,250,337,1927
E02001872,828,288,190,251,1557
E02001873,879,162,127,176,1344
E02001874,733,111,97,132,1073
E02001875,478,80,74,83,715
E02001876,542,95,73,133,843
E02001877,879,137,98,186,1300
E02001878,608,107,75,144,934
E02001879,899,127,124,243,1393
E02001880,878,198,151,156,1383
E02001881,770,147,107,167,1191
E02001882,848,264,227,299,1638
E02001883,853,291,182,267,1593
E02001884,546,102,66,118,832
E02001886,1280,271,180,265,1996
E02001888,765,229,177,259,1430
E02001889,563,120,92,167,942
E02001890,1527,301,251,363,2442
E02001892,862,191,140,189,1382
E02001893,1055,313,240,390,1998
E02001895,1036,321,236,365,1958
E02001896,510,119,81,210,920
E02001897,448,138,97,168,851
E02001898,910,290,272,335,1807
E02001899,1783,457,385,618,3243
E02001900,829,209,172,244,1454
E02001901,1944,286,191,298,2719
E02001902,796,207,173,238,1414
E02001903,369,99,65,128,661
E02001904,611,159,118,201,1089
E02001905,1370,256,215,334,2175
E02001906,1293,383,292,394,2362
E02001907,1285,436,367,479,2567
E02001908,454,113,91,149,807
E02001909,397,88,86,138,709
E02001910,460,116,93,156,825
E02001911,947,239,188,260,1634
E02001913,1453,243,199,319,2214
E02001914,890,198,123,188,1399
E02001915,1294,364,283,440,2381
E02001916,745,226,166,220,1357
E02001918,1225,341,169,288,2023
E02001919,794,188,138,283,1403
E02001920,1216,357,256,216,2045
E02001921,1309,276,216,264,2065
E02001922,1184,66,45,102,1397
E02001923,966,298,223,361,1848
E02001924,789,185,143,226,1343
E02001925,1051,303,240,382,1976
E02001926,1034,232,191,341,1798
E02001927,1234,222,199,326,1981
E02001928,1189,370,237,264,2060
E02001929,929,229,152,243,1553
E02001930,1218,254,194,195,1861
E02001931,1136,390,267,375,2168
E02001932,1122,242,150,208,1722
E02001933,1035,248,202,276,1761
E02001934,876,265,202,293,1636
E02001935,1326,351,287,516,2480
E02001936,924,312,275,362,1873
E02001937,975,268,187,294,1724
E02001938,1264,251,173,243,1931
E02001939,1156,375,307,503,2341
E02001941,714,205,155,288,1362
E02001942,1168,282,217,330,1997
E02001943,851,261,153,237,1502
E02001944,1199,342,221,270,2032
E02001945,1146,221,168,187,1722
E02001946,1419,427,269,398,2513
E02001947,688,165,168,264,1285
E02001948,959,296,230,347,1832
E02001949,795,206,164,310,1475
E02001950,1557,436,328,397,2718
E02001951,1258,404,224,212,2098
E02001952,1587,313,211,268,2379
E02001953,1145,452,287,441,2325
E02001954,1014,353,205,238,1810
E02001955,1101,256,231,427,2015
E02001956,1035,261,187,216,1699
E02001957,1328,336,315,375,2354
E02006807,1061,311,256,362,1990
E02006809,1882,357,204,427,2870
E02006895,685,100,63,114,962
E02006896,430,54,41,58,583
E02006897,521,72,57,56,706
E02006898,691,64,48,56,859
E02006899,532,43,19,14,608
E02006900,837,169,143,292,1441
E02006901,804,194,149,257,1404
E02001958,1170,277,238,272,1957
E02001959,1083,270,219,365,1937
E02001961,1115,229,196,229,1769
E02001962,774,161,98,188,1221
E02001963,1062,277,210,294,1843
E02001964,1383,213,180,246,2022
E02001965,1623,377,288,394,2682
E02001966,707,114,90,135,1046
E02001967,1137,430,393,509,2469
E02001968,1013,198,159,228,1598
E02001969,894,241,181,290,1606
E02001970,913,248,283,463,1907
E02001971,950,268,211,262,1691
E02001972,992,191,117,198,1498
E02001973,1117,279,178,226,1800
E02001974,1341,393,327,497,2558
E02001975,1376,251,212,288,2127
E02001976,1408,375,260,391,2434
E02001977,877,210,157,195,1439
E02001978,980,217,167,230,1594
E02001979,760,258,239,486,1743
E02001980,786,439,390,486,2101
E02001981,986,157,114,151,1408
E02001982,973,343,284,437,2037
E02001983,1026,330,233,334,1923
E02001984,1624,322,289,330,2565
E02001985,644,80,79,120,923
E02001986,930,315,245,316,1806
E02001987,655,175,141,241,1212
E02001988,700,169,122,194,1185
E02001989,693,245,157,222,1317
E02001990,1803,501,375,581,3260
E02001991,1302,486,342,550,2680
E02001992,1647,380,303,293,2623
E02001993,954,312,231,264,1761
E02001994,1085,384,289,389,2147
E02001995,1082,265,233,337,1917
E02001996,1029,210,158,247,1644
E02001997,1461,451,392,649,2953
E02001998,890,315,299,395,1899
E02001999,1115,300,254,340,2009
E02006805,1203,238,172,296,1909
E02002000,976,335,256,405,1972
E02002001,892,265,228,349,1734
E02002002,1068,524,526,738,2856
E02002003,1181,429,369,598,2577
E02002004,1036,295,246,375,1952
E02002005,999,269,257,280,1805
E02002006,887,247,214,287,1635
E02002007,1199,527,491,742,2959
E02002008,1224,289,222,329,2064
E02002009,607,192,143,165,1107
E02002010,785,221,209,338,1553
E02002011,816,412,356,422,2006
E02002012,1124,311,270,476,2181
E02002013,895,439,433,629,2396
E02002014,748,258,163,231,1400
E02002015,920,346,249,344,1859
E02002016,929,301,214,331,1775
E02002017,955,347,263,391,1956
E02002018,1181,655,586,740,3162
E02002019,973,306,259,325,1863
E02002020,1228,612,529,661,3030
E02002021,854,255,190,283,1582
E02002022,1203,336,211,265,2015
E02002023,698,343,366,262,1669
E02002024,1086,398,326,398,2208
E02002025,1210,326,279,347,2162
E02002026,1043,458,323,320,2144
E02002027,987,334,184,130,1635
E02002028,795,344,308,512,1959
E02002029,957,318,304,479,2058
E02002030,861,338,272,320,1791
E02002031,703,289,188,207,1387
E02002032,1200,432,320,389,2341
E02002033,1174,477,354,415,2420
E02002034,1013,408,310,422,2153
E02002035,1083,439,326,426,2274
E02002036,579,292,233,257,1361
E02002037,767,374,272,327,1740
E02002038,1348,523,504,490,2865
E02002039,724,361,276,501,1862
E02002040,821,466,371,514,2172
E02002041,795,415,392,565,2167
E02002042,1222,503,416,561,2702
E02002043,1256,279,206,297,2038
E02002044,984,271,170,206,1631
E02002045,1144,262,228,343,1977
E02002046,758,169,141,136,1204
E02002047,982,363,308,406,2059
E02002048,1086,321,312,478,2197
E02002049,787,264,213,230,1494
E02002051,746,199,143,158,1246
E02002052,1266,374,237,429,2306
E02002053,767,235,229,324,1555
E02002054,738,271,245,330,1584
E02002055,1269,378,254,363,2264
E02002056,1151,308,233,287,1979
E02002057,1262,350,261,382,2255
E02002058,1413,358,266,351,2388
E02002059,1348,414,297,428,2487
E02002060,697,186,120,236,1239
E02002061,632,178,147,250,1207
E02002062,881,253,193,302,1629
E02002063,1140,291,183,275,1889
E02002064,1504,450,353,451,2758
E02002065,1454,267,225,335,2281
E02002066,875,211,159,227,1472
E02002067,777,263,268,361,1669
E02002068,1257,210,115,189,1771
E02002069,791,278,230,334,1633
E02002070,1033,230,234,339,1836
E02002071,858,285,244,256,1643
E02002072,1261,346,254,340,2201
E02002073,1112,317,217,287,1933
E02002074,1175,328,270,322,2095
E02002075,1107,382,284,359,2132
E02002076,1416,298,225,299,2238
E02002077,1420,398,343,401,2562
E02002078,976,321,273,339,1909
E02002079,1183,380,286,363,2212
E02002080,919,283,217,331,1750
E02006810,1410,548,385,538,2881
E02002081,909,408,274,323,1914
E02002082,759,257,199,124,1339
E02002083,922,385,269,403,1979
E02002084,932,284,194,235,1645
E02002085,844,263,176,254,1537
E02002086,748,275,214,197,1434
E02002087,777,235,192,228,1432
E02002088,1151,394,353,339,2237
E02002089,1153,459,366,384,2362
E02002090,794,219,200,256,1469
E02002091,1044,332,297,541,2214
E02002092,1023,329,304,417,2073
E02002093,898,303,273,454,1928
E02002094,958,351,299,500,2108
E02002095,1442,534,387,443,2806
E02002096,1573,596,505,909,3583
E02002097,1201,481,377,438,2497
E02002098,1345,451,349,689,2834
E02002099,1045,372,332,598,2347
E02002101,831,326,299,435,1891
E02002102,1146,430,320,623,2519
E02002103,911,434,300,493,2138
E02002104,916,379,254,308,1857
E02002105,1172,517,445,586,2720
E02002106,1440,723,610,889,3662
E02002107,802,375,239,263,1679
E02002108,1413,600,473,721,3207
E02002109,1472,555,387,373,2787
E02006808,832,272,201,304,1609
E02002110,1010,311,260,277,1858
E02002111,911,335,293,375,1914
E02002112,856,313,264,283,1716
E02002113,920,319,242,336,1817
E02002114,910,379,328,580,2197
E02002115,935,331,273,426,1965
E02002116,1115,450,394,505,2464
E02002117,1073,353,205,299,1930
E02002118,987,292,229,422,1930
E02002119,936,293,258,338,1825
E02002120,1036,320,199,210,1765
E02002121,816,239,184,311,1550
E02002122,688,172,105,191,1156
E02002123,874,310,272,367,1823
E02002124,1095,392,343,696,2526
E02002125,931,306,198,327,1762
E02002126,859,218,154,203,1434
E02002127,872,235,171,255,1533
E02002128,829,326,312,385,1852
E02002129,936,341,281,324,1882
E02002130,798,217,194,213,1422
E02002131,1351,475,448,612,2886
E02002132,916,273,186,278,1653
E02002133,918,315,233,337,1803
E02002134,1192,281,243,288,2004
E02002135,838,187,147,170,1342
E02002136,1056,277,200,214,1747
E02002137,1113,351,363,604,2431
E02002138,871,246,198,301,1616
E02002139,1052,244,161,262,1719
E02002140,748,270,174,255,1447
E02002141,1113,338,351,485,2287
E02002142,748,215,124,165,1252
E02002143,882,215,168,199,1464
E02002144,1353,420,321,504,2598
E02002145,946,219,173,223,1561
E02002146,862,213,164,253,1492
E02002147,1003,286,201,325,1815
E02002148,1566,500,463,816,3345
E02002149,1489,483,400,582,2954
E02002150,769,212,152,261,1394
E02002151,800,215,143,151,1309
E02002152,818,197,150,260,1425
E02002153,1100,302,299,551,2252
E02002154,846,209,131,185,1371
E02002155,677,154,115,186,1132
E02002156,1428,340,286,451,2505
E02002157,1159,351,285,472,2267
E02002158,1049,386,305,565,2305
E02002159,605,143,94,123,965
E02002160,1212,341,291,335,2179
E02002161,657,140,95,122,1014
E02002162,1288,459,445,883,3075
E02002163,1284,249,181,239,1953
E02002164,409,86,75,97,667
E02002165,937,198,135,256,1526
E02002166,1009,330,299,399,2037
E02002167,1019,379,324,429,2151
E02002168,1080,211,147,276,1714
E02002169,1473,565,399,696,3133
E02002170,864,264,189,287,1604
E02002171,950,368,266,310,1894
E02002174,1208,400,269,366,2243
E02002175,840,289,192,289,1610
E02002176,1129,384,299,316,2128
E02002177,1080,301,224,288,1893
E02002178,1308,394,279,481,2462
E02002179,1052,332,236,417,2037
E02002180,812,279,248,427,1766
E02002181,950,291,228,281,1750
E02002182,952,278,192,296,1718
E02006894,1232,385,271,456,2344
E02002652,2167,366,173,163,2869
E02002653,1019,328,210,297,1854
E02002654,759,184,108,213,1264
E02002655,1195,375,223,262,2055
E02002656,790,411,291,501,1993
E02002657,1219,512,323,363,2417
E02002658,1047,415,244,430,2136
E02002659,1457,339,224,374,2394
E02002660,967,383,223,350,1923
E02002661,1117,370,253,411,2151
E02002662,1086,420,266,449,2221
E02002663,965,203,135,135,1438
E02002664,1085,477,285,333,2180
E02002665,1394,413,288,370,2465
E02002666,667,154,116,167,1104
E02002667,962,329,208,257,1756
E02002668,941,361,225,333,1860
E02002669,1016,221,128,147,1512
E02002670,1315,386,270,424,2395
E02002671,1185,299,191,297,1972
E02002672,712,224,138,265,1339
E02002673,964,351,206,286,1807
E02002674,1192,322,219,293,2026
E02002675,747,241,145,190,1323
E02002676,985,250,170,225,1630
E02002677,1084,332,201,234,1851
E02002678,1177,274,173,221,1845
E02002679,1289,415,286,408,2398
E02002680,912,263,159,256,1590
E02002681,847,205,158,217,1427
E02002682,1348,362,233,265,2208
E02006813,1252,459,298,512,2521
E02002684,1501,1103,886,992,4482
E02002685,1147,801,623,735,3306
E02002686,1086,519,358,515,2478
E02002687,931,393,336,404,2064
E02002688,880,341,238,286,1745
E02002689,857,449,348,437,2091
E02002691,1027,656,493,588,2764
E02002692,1370,645,468,552,3035
E02002693,938,602,428,445,2413
E02002694,1743,851,648,780,4022
E02002695,1116,739,571,744,3170
E02002696,763,436,299,334,1832
E02002697,984,641,457,550,2632
E02002698,1021,571,394,463,2449
E02002699,1273,717,546,774,3310
E02002700,677,282,216,313,1488
E02002701,1194,642,406,439,2681
E02002702,1274,686,473,796,3229
E02002703,1260,588,411,575,2834
E02002704,1147,695,409,465,2716
E02002705,1202,552,374,600,2728
E02002706,1268,472,333,581,2654
E02002707,1006,497,377,488,2368
E02002708,977,474,339,704,2494
E02002709,1302,523,349,488,2662
E02002710,1366,433,363,563,2725
E02002711,1413,637,440,755,3245
E02002712,1074,633,432,585,2724
E02002714,1033,620,431,489,2573
E02002715,1905,644,483,691,3723
E02002716,1205,611,416,578,2810
E02002717,1310,385,258,447,2400
E02002718,1378,620,469,634,3101
E02002719,1179,346,251,553,2329
E02002720,1138,477,331,517,2463
E02002721,1065,409,290,417,2181
E02002722,1070,739,448,521,2778
E02002723,1016,437,352,474,2279
E02002724,1205,380,240,299,2124
E02002725,961,433,301,406,2101
E02006814,1385,525,342,456,2708
E02006891,1146,560,418,529,2653
E02006892,794,420,340,524,2078
E02002726,1681,582,424,553,3240
E02002727,617,190,122,184,1113
E02002728,803,260,140,196,1399
E02002729,809,367,238,246,1660
E02002730,777,219,140,136,1272
E02002731,606,133,90,103,932
E02002732,1283,451,355,473,2562
E02002733,788,284,189,341,1602
E02002734,699,269,210,342,1520
E02002735,647,216,151,272,1286
E02002736,702,128,80,101,1011
E02002737,1050,342,226,403,2021
E02002738,988,435,271,290,1984
E02002739,859,318,216,358,1751
E02002740,801,245,166,281,1493
E02002741,1375,414,274,477,2540
E02002742,702,414,292,389,1797
E02002743,800,502,339,592,2233
E02002744,981,261,139,208,1589
E02002745,1058,629,561,673,2921
E02002746,1601,526,436,674,3237
E02002747,1333,605,506,691,3135
E02002748,1238,604,452,726,3020
E02002749,2075,697,497,613,3882
E02002750,1070,445,282,326,2123
E02002751,1220,455,308,335,2318
E02002752,1244,430,297,321,2292
E02002753,1479,601,492,691,3263
E02002754,1466,513,353,425,2757
E02002755,858,255,190,328,1631
E02002756,856,215,134,221,1426
E02002757,959,269,249,357,1834
E02002758,878,227,168,196,1469
E02002759,1890,728,478,672,3768
E02002760,949,371,223,325,1868
E02002761,1253,419,323,387,2382
E02002762,987,274,189,413,1863
E02002763,1172,281,218,283,1954
E02002764,730,218,176,211,1335
E02002765,864,286,208,349,1707
E02002766,1288,534,414,582,2818
E02002767,1062,477,350,487,2376
E02002768,1147,521,371,434,2473
E02002769,900,436,399,445,2180
E02002770,1309,480,363,439,2591
E02002771,1127,573,384,463,2547
E02002772,1207,394,264,347,2212
E02002773,1114,552,392,519,2577
E02002774,1188,474,355,561,2578
E02002775,1104,410,333,580,2427
E02002776,1172,415,324,468,2379
E02002777,1401,353,241,343,2338
E02002778,1212,441,333,537,2523
E02002779,1444,623,463,663,3193
E02002780,1180,234,156,225,1795
E02002781,1156,257,163,281,1857
E02002782,1063,412,322,599,2396
E02002783,1619,518,363,545,3045
E02002784,1221,376,277,338,2212
E02002785,1019,376,305,519,2219
E02002786,1020,264,161,216,1661
E02002787,1363,389,270,485,2507
E02002788,1237,357,216,219,2029
E02002789,1394,362,223,320,2299
E02002790,1236,371,278,403,2288
E02002791,930,474,373,574,2351
E02002792,1122,339,276,460,2197
E02002793,1421,629,401,554,3005
E02002794,997,315,253,390,1955
E02002795,1445,706,486,606,3243
E02005742,1010,565,467,545,2587
E02005743,779,414,369,524,2086
E02005744,1307,653,498,690,3148
E02005745,707,423,322,394,1846
E02005746,947,429,315,449,2140
E02005747,857,356,243,372,1828
E02005748,1090,495,328,396,2309
E02005749,1429,631,531,706,3297
E02005750,1073,579,507,681,2840
E02005751,1326,778,698,768,3570
E02005752,997,538,355,381,2271
E02005753,2091,783,558,945,4377
E02005754,1148,662,489,613,2912
E02005755,865,436,313,550,2164
E02005756,741,409,277,304,1731
E02005757,1137,548,422,650,2757
E02005758,1147,590,427,586,2750
E02005759,1294,688,547,800,3329
E02005760,860,398,224,309,1791
E02005761,583,438,308,372,1701
E02005762,645,392,269,464,1770
E02005763,715,427,337,371,1850
E02005764,1240,626,534,789,3189
E02005765,894,475,352,534,2255
E02005766,662,496,326,399,1883
E02005767,1100,501,343,498,2442
E02005768,859,365,248,309,1781
E02005769,1077,433,322,522,2354
E02005770,1331,563,410,549,2853
E02005771,1011,335,220,286,1852
E02005772,1014,505,360,451,2330
E02005773,1366,396,233,448,2443
E02005774,1582,459,325,570,2936
E02005775,1105,431,328,562,2426
E02005776,1257,544,382,422,2605
E02005777,1160,512,364,620,2656
E02005778,704,419,349,438,1910
E02005779,844,425,348,666,2283
E02005780,1175,656,513,927,3271
E02005781,733,431,345,454,1963
E02005782,963,600,439,547,2549
E02005783,755,538,454,632,2379
E02005784,564,368,237,334,1503
E02005785,1109,282,209,278,1878
E02005786,566,532,347,420,1865
E02005787,771,724,503,667,2665
E02005788,772,574,374,516,2236
E02005789,1692,957,720,1020,4389
E02005790,993,476,424,616,2509
E02005791,1059,431,317,343,2150
E02005794,1426,704,519,606,3255
E02006870,2213,786,609,899,4507
E02005795,798,517,384,565,2264
E02005796,835,580,338,459,2212
E02005797,724,473,293,304,1794
E02005798,1201,770,550,628,3149
E02005799,1750,806,566,943,4065
E02005800,1075,355,262,337,2029
E02005801,896,300,219,310,1725
E02005802,1215,313,235,312,2075
E02005803,1686,613,460,706,3465
E02005804,1215,531,350,654,2750
E02005805,1353,629,541,585,3108
E02005806,1248,381,253,315,2197
E02005807,1158,545,387,473,2563
E02005808,1995,1038,876,1111,5020
E02005809,1088,473,371,473,2405
E02005810,1424,547,402,368,2741
E02005811,1423,632,421,496,2972
E02005812,1643,561,332,460,2996
E02005813,1447,456,286,451,2640
E02005814,909,450,359,482,2200
E02005815,1226,604,439,531,2800
E02005816,1190,529,334,371,2424
E02005817,1007,488,330,382,2207
E02005818,1243,517,377,384,2521
E02001509,948,374,261,324,1907
E02001510,778,313,227,247,1565
E02001511,930,325,276,335,1866
E02001512,1195,487,354,504,2540
E02001513,1093,452,385,385,2315
E02001514,1025,324,211,260,1820
E02001515,1147,440,251,309,2147
E02001516,836,249,182,231,1498
E02001517,1140,487,394,466,2487
E02001518,1414,490,318,408,2630
E02001519,1056,318,224,292,1890
E02001520,1843,757,570,788,3958
E02001521,1227,389,267,308,2191
E02001522,1117,428,333,389,2267
E02001523,920,319,280,343,1862
E02001524,993,482,406,398,2279
E02001525,708,240,207,267,1422
E02001526,685,269,206,182,1342
E02001527,863,387,276,300,1826
E02001528,1335,628,450,555,2968
E02001529,1207,460,384,580,2631
E02001530,800,228,198,222,1448
E02001531,788,395,275,321,1779
E02001532,1450,598,375,478,2901
E02001533,847,386,224,280,1737
E02001534,1064,401,259,393,2117
E02001535,867,439,329,364,1999
E02001536,1033,493,421,563,2510
E02001537,959,396,280,300,1935
E02001538,910,415,381,405,2111
E02001539,947,274,205,218,1644
E02001540,1398,618,434,598,3048
E02001541,2043,623,506,672,3844
E02001542,1092,396,262,339,2089
E02001543,1004,445,334,423,2206
E02001544,1211,428,363,420,2422
E02001545,1373,651,418,580,3022
E02001546,1129,470,363,532,2494
E02001547,1181,429,268,409,2287
E02001548,754,286,228,270,1538
E02001549,1015,350,261,356,1982
E02001550,977,352,234,350,1913
E02001551,621,287,170,228,1306
E02001552,1230,327,228,337,2122
E02001553,1315,469,298,442,2524
E02001554,744,315,283,398,1740
E02001555,1020,409,294,366,2089
E02001556,1096,380,217,347,2040
E02001557,1216,351,233,397,2197
E02001558,875,466,379,450,2170
E02001559,1034,460,368,513,2375
E02001560,817,263,168,208,1456
E02001561,644,172,152,185,1153
E02001562,927,303,223,388,1841
E02001563,1230,527,375,644,2776
E02001564,1298,614,422,501,2835
E02001565,1256,520,366,451,2593
E02001566,1003,223,146,172,1544
E02001567,1144,453,281,428,2306
E02001568,894,363,246,270,1773
E02001569,1037,350,314,356,2057
E02001570,893,374,241,329,1837
E02001571,859,375,287,350,1871
E02001572,935,323,204,321,1783
E02001573,1120,346,217,386,2069
E02001574,841,409,266,312,1828
E02001575,855,300,209,316,1680
E02001576,839,320,249,307,1715
E02001577,996,564,487,603,2650
E02001578,1373,432,274,350,2429
E02001579,1265,508,379,554,2706
E02001580,1210,541,399,501,2651
E02001581,953,349,203,271,1776
E02001582,1135,374,298,350,2157
E02001583,824,233,177,211,1445
E02001584,1046,467,314,334,2161
E02001585,852,276,197,244,1569
E02001586,1333,435,376,470,2614
E02001587,823,292,235,251,1601
E02001588,1093,290,173,344,1900
E02001589,1456,457,317,377,2607
E02001590,922,249,185,178,1534
E02001591,955,260,177,247,1639
E02001592,1386,505,366,408,2665
E02001593,790,182,126,150,1248
E02001594,703,168,142,250,1263
E02001595,1506,475,361,473,2815
E02001596,1535,549,442,614,3140
E02001597,1536,426,292,388,2642
E02001598,1561,523,418,671,3173
E02001599,1251,390,320,418,2379
E02001600,1697,528,426,624,3275
E02001601,828,297,222,315,1662
E02001602,1146,522,426,521,2615
E02001603,1035,401,241,320,1997
E02001604,1462,396,300,322,2480
E02001605,1066,387,293,373,2119
E02001606,1083,480,369,445,2377
E02001607,1193,527,391,494,2605
E02001608,945,404,317,312,1978
E02001609,1204,662,576,542,2984
E02001610,1144,544,467,502,2657
E02001611,867,509,399,528,2303
E02001612,723,364,305,283,1675
E02001613,1354,665,466,550,3035
E02001614,1509,716,566,724,3515
E02001615,1128,586,487,599,2800
E02001616,914,410,319,462,2105
E02001617,724,136,128,211,1199
E02001618,1221,550,426,461,2658
E02001619,1247,371,264,419,2301
E02001620,906,219,210,216,1551
E02001621,743,199,166,211,1319
E02001622,1033,318,260,431,2042
E02001623,814,289,208,337,1648
E02001624,1093,357,361,364,2175
E02001625,992,295,204,296,1787
E02001626,767,291,202,309,1569
E02001627,787,210,130,190,1317
E02001628,403,157,124,192,876
E02001629,726,190,198,335,1449
E02001630,622,171,156,315,1264
E02001631,1099,339,305,395,2138
E02001632,609,159,134,228,1130
E02001633,1242,500,411,566,2719
E02001634,1391,371,263,347,2372
E02001635,860,319,318,465,1962
E02001636,1002,293,207,335,1837
E02001637,549,133,127,215,1024
E02001638,790,144,77,110,1121
E02001639,878,223,173,329,1603
E02001640,1164,173,125,246,1708
E02001642,1111,415,341,484,2351
E02001643,1057,387,299,466,2209
E02001646,983,200,131,219,1533
E02001647,799,323,300,389,1811
E02001648,1170,326,233,290,2019
E02001649,1420,320,251,225,2216
E02001650,936,118,88,163,1305
E02001651,1493,563,423,586,3065
E02001652,793,129,98,132,1152
E02001653,760,200,200,213,1373
E02001654,936,292,264,510,2002
E02001655,1084,389,275,330,2078
E02001656,1351,261,180,256,2048
E02001657,1652,423,266,372,2713
E02001658,535,153,153,155,996
E02001659,967,294,184,320,1765
E02001660,1588,381,238,362,2569
E02001661,1030,282,213,339,1864
E02001662,1089,378,337,540,2344
E02001663,1119,193,142,220,1674
E02001664,904,366,276,426,1972
E02001665,1820,669,440,716,3645
E02001666,959,265,200,233,1657
E02001669,1039,275,233,340,1887
E02001670,764,208,168,267,1407
E02001671,948,399,358,396,2101
E02001672,863,308,244,419,1834
E02001673,986,261,163,218,1628
E02001674,1438,567,483,705,3193
E02001675,1281,607,439,500,2827
E02001676,940,368,274,446,2028
E02001678,1613,707,602,930,3852
E02001679,790,279,222,312,1603
E02001680,723,229,174,289,1415
E02001681,1057,501,377,559,2494
E02006803,1362,505,365,466,2698
E02006843,623,32,11,10,676
E02006844,607,48,24,71,750
E02006868,1253,350,282,371,2256
E02006869,1610,503,396,588,3097
E02002183,1008,484,413,627,2532
E02002184,1935,801,658,1383,4777
E02002185,874,376,256,379,1885
E02002186,2171,864,606,867,4508
E02002187,820,387,288,444,1939
E02002188,1158,474,260,389,2281
E02002189,892,230,183,339,1644
E02002190,1243,312,213,315,2083
E02002191,970,227,193,247,1637
E02002192,1625,647,468,675,3415
E02002193,760,268,197,197,1422
E02002194,992,405,242,330,1969
E02002195,1089,516,335,446,2386
E02002196,862,353,187,239,1641
E02002197,1218,447,309,569,2543
E02002198,1289,502,322,509,2622
E02002199,1175,356,249,363,2143
E02002200,1452,510,368,567,2897
E02002201,1962,558,352,481,3353
E02002202,1055,286,188,307,1836
E02002203,1130,320,196,249,1895
E02002204,1914,800,503,753,3970
E02002205,1374,653,355,466,2848
E02002206,1409,358,283,411,2461
E02002207,968,182,114,225,1489
E02002208,1258,336,241,368,2203
E02002209,765,162,97,121,1145
E02002210,1029,303,171,349,1852
E02002211,901,201,125,204,1431
E02002212,848,102,82,183,1215
E02002213,1137,437,305,328,2207
E02002214,862,213,139,223,1437
E02002215,959,147,105,188,1399
E02002216,889,164,97,187,1337
E02002217,784,190,126,238,1338
E02002218,1291,365,204,325,2185
E02002219,681,91,67,118,957
E02002220,787,148,64,124,1123
E02002221,1261,143,99,156,1659
E02002222,950,249,157,311,1667
E02002223,568,115,57,92,832
E02002224,685,129,71,164,1049
E02002225,1231,447,270,359,2307
E02002226,1074,151,85,222,1532
E02002227,552,112,81,99,844
E02002228,886,218,134,200,1438
E02002229,1162,382,238,346,2128
E02002230,694,103,72,115,984
E02002231,1495,394,223,378,2490
E02002232,654,175,102,191,1122
E02002233,911,141,89,103,1244
E02002234,902,189,133,174,1398
E02002235,680,144,93,139,1056
E02002236,870,248,171,281,1570
E02002237,1105,289,175,306,1875
E02002238,814,232,139,196,1381
E02002239,1494,366,204,289,2353
E02002240,1645,546,315,426,2932
E02002241,1731,473,295,439,2938
E02002242,1312,468,306,461,2547
E02002243,1317,501,337,388,2543
E02002244,837,373,263,311,1784
E02002245,608,190,132,124,1054
E02002246,1663,631,468,559,3321
E02002247,1429,557,304,339,2629
E02002248,1156,354,219,251,1980
E02002249,725,205,151,183,1264
E02002250,1233,511,353,440,2537
E02002251,1103,332,231,398,2064
E02002252,879,363,270,340,1852
E02002253,739,154,143,184,1220
E02002254,1000,379,267,380,2026
E02002255,672,110,110,285,1177
E02002256,1324,480,335,389,2528
E02002257,542,100,74,91,807
E02002258,1250,472,327,427,2476
E02002259,1141,323,231,420,2115
E02002260,1219,481,311,335,2346
E02002261,1322,404,280,338,2344
E02002262,994,455,352,518,2319
E02002263,985,358,232,233,1808
E02002264,1277,407,323,475,2482
E02002265,820,349,214,276,1659
E02002266,787,361,300,339,1787
E02002267,1189,495,344,372,2400
E02002268,1427,502,375,545,2849
E02002269,1431,533,372,383,2719
E02002270,1244,459,348,320,2371
E02002271,1294,433,298,469,2494
E02002272,1508,484,337,420,2749
E02002273,1081,374,244,316,2015
E02002274,1212,351,265,343,2171
E02002275,1315,458,309,444,2526
E02002276,1018,378,277,269,1942
E02002277,704,258,194,287,1443
E02002278,1084,380,265,241,1970
E02002279,986,300,202,260,1748
E02002280,651,189,130,155,1125
E02002281,1485,468,314,429,2696
E02002282,762,187,131,170,1250
E02002283,664,197,117,153,1131
E02002284,971,282,224,303,1780
E02002285,1376,484,335,420,2615
E02002286,854,201,99,163,1317
E02002287,770,172,130,212,1284
E02002288,1368,387,269,376,2400
E02002289,641,125,85,108,959
E02002290,1066,430,356,428,2280
E02002291,1091,385,324,345,2145
E02002292,938,317,220,298,1773
E02002293,672,140,85,112,1009
E02002294,1135,232,188,245,1800
E02002295,926,181,159,180,1446
E02002296,1071,443,367,530,2411
E02002297,1117,388,254,338,2097
E02002298,1090,376,241,362,2069
E02002299,685,132,105,183,1105
E02002300,1385,390,339,523,2637
E02002301,773,117,92,187,1169
E02002302,988,405,253,335,1981
E02002303,1062,289,217,362,1930
E02002304,968,230,184,245,1627
E02002305,855,193,143,215,1406
E02002306,1165,347,235,318,2065
E02002307,985,297,230,290,1802
E02002308,1135,275,213,255,1878
E02002309,839,206,151,221,1417
E02002310,801,249,192,293,1535
E02002311,1237,347,201,267,2052
E02002312,900,184,136,173,1393
E02002313,694,117,106,154,1071
E02002314,916,355,297,405,1973
E02002315,1070,251,155,197,1673
E02002316,964,474,293,406,2137
E02002317,994,243,188,294,1719
E02002318,919,388,246,335,1888
E02002319,972,330,226,287,1815
E02002320,1071,434,308,413,2226
E02002321,1007,426,306,321,2060
E02002322,946,400,269,288,1903
E02002323,1171,595,385,498,2649
E02002324,858,514,372,375,2119
E02002325,1277,584,380,502,2743
E02002326,928,376,290,279,1873
E02002327,1308,627,472,586,2993
E02002328,1036,444,322,409,2211
E02002329,1803,798,516,462,3579
E02002330,924,574,456,519,2473
E02002331,796,428,376,690,2290
E02002332,974,418,307,370,2069
E02002333,1226,558,373,562,2719
E02002334,1012,522,441,530,2505
E02002335,1108,555,445,542,2650
E02002336,969,455,331,501,2256
E02002337,868,477,298,410,2053
E02002338,824,414,297,450,1985
E02002339,678,284,194,304,1460
E02002340,795,405,284,403,1887
E02002341,1531,470,333,547,2881
E02002342,986,365,253,425,2029
E02002343,729,317,214,260,1520
E02002344,1488,487,298,537,2810
E02002345,1158,400,235,383,2176
E02002346,901,272,182,287,1642
E02002347,1136,253,150,254,1793
E02002348,1011,309,193,361,1874
E02002349,1118,274,201,314,1907
E02002350,879,361,304,500,2044
E02002351,970,386,284,415,2055
E02002352,1412,354,258,395,2419
E02002353,1195,234,146,199,1774
E02002354,1410,310,232,429,2381
E02002356,1239,442,291,408,2380
E02002357,1184,355,245,417,2201
E02002358,1366,443,254,377,2440
E02002359,969,443,346,466,2224
E02002360,1272,223,173,290,1958
E02002361,1072,201,119,224,1616
E02002362,1316,279,177,249,2021
E02002363,1306,276,187,280,2049
E02002364,905,252,132,314,1603
E02002366,1204,331,255,454,2244
E02002367,940,175,101,187,1403
E02002368,1292,429,299,422,2442
E02002369,942,211,184,229,1566
E02002370,1001,262,188,258,1709
E02002371,1207,197,143,292,1839
E02002373,836,101,77,113,1127
E02002374,1019,219,152,205,1595
E02002375,858,175,98,130,1261
E02002376,940,139,95,176,1350
E02002377,749,87,58,96,990
E02002379,779,160,95,123,1157
E02002380,852,282,169,274,1577
E02002381,951,274,142,223,1590
E02002382,539,54,47,101,741
E02002383,583,43,27,35,688
E02002384,1015,148,110,139,1412
E02002385,886,115,72,122,1195
E02002386,1477,621,454,709,3261
E02002387,874,196,141,199,1410
E02002388,1022,249,138,254,1663
E02002389,1009,227,157,234,1627
E02002390,1017,267,179,237,1700
E02002391,1092,366,215,326,1999
E02002392,895,53,26,45,1019
E02002393,980,115,78,124,1297
E02002394,868,157,113,122,1260
E02002395,1053,282,198,347,1880
E02002396,1221,352,216,376,2165
E02002397,1016,355,238,336,1945
E02002398,1279,443,343,570,2635
E02002399,835,211,105,173,1324
E02002400,808,176,123,182,1289
E02002401,858,205,130,172,1365
E02002402,928,317,233,394,1872
E02002403,790,427,323,554,2094
E02002404,1323,184,125,157,1789
E02002405,1234,377,338,522,2471
E02002406,986,525,415,421,2347
E02002407,849,172,139,198,1358
E02002408,1020,349,277,386,2032
E02002409,1117,275,190,273,1855
E02002410,950,307,214,316,1787
E02002411,787,136,78,183,1184
E02002412,1294,298,195,280,2067
E02002414,672,154,111,168,1105
E02002415,545,59,37,61,702
E02002416,967,446,422,485,2320
E02002417,992,398,318,387,2095
E02002418,1021,399,294,297,2011
E02002419,1151,252,176,262,1841
E02002420,1057,256,209,284,1806
E02002421,753,183,108,197,1241
E02002422,907,367,255,333,1862
E02002423,763,240,165,214,1382
E02002424,1007,391,255,343,1996
E02002425,1286,546,397,494,2723
E02002426,1114,391,323,507,2335
E02002427,949,395,307,410,2061
E02002428,1089,269,193,248,1799
E02002429,1256,401,364,400,2421
E02002430,1023,216,153,210,1602
E02002431,1068,330,189,197,1784
E02002432,1017,379,315,393,2104
E02002433,878,325,206,299,1708
E02002434,1464,321,199,269,2253
E02002435,965,380,299,362,2006
E02002436,1013,301,257,289,1860
E02002437,1033,340,202,257,1832
E02006852,1874,470,291,450,3085
E02006861,1232,118,91,245,1686
E02006875,661,22,12,10,705
E02006876,833,195,127,239,1394
E02002438,1175,354,237,289,2055
E02002439,1114,409,271,376,2170
E02002440,1079,401,289,356,2125
E02002441,1116,410,365,414,2305
E02002442,959,313,256,263,1791
E02002443,1009,296,216,183,1704
E02002444,1109,317,239,229,1894
E02002445,1191,502,332,487,2512
E02002446,1105,367,296,362,2130
E02002447,845,310,222,324,1701
E02002448,1039,365,240,359,2003
E02002449,1385,420,319,394,2518
E02002450,1296,368,220,288,2172
E02002451,1141,526,378,449,2494
E02002452,1246,402,265,391,2304
E02002453,1563,466,309,372,2710
E02002454,945,250,157,313,1665
E02002455,926,295,182,267,1670
E02002456,786,267,200,187,1440
E02002457,1002,337,193,271,1803
E02002458,1166,543,371,453,2533
E02002459,1227,372,262,342,2203
E02002460,1258,515,360,597,2730
E02002461,1653,482,390,471,2996
E02002462,1014,472,326,384,2196
E02002463,1153,343,250,364,2110
E02002464,1349,398,310,367,2424
E02002465,823,378,320,390,1911
E02002466,1222,565,442,507,2736
E02002467,996,281,157,196,1630
E02002468,896,412,262,335,1905
E02002469,968,415,311,290,1984
E02002470,942,505,418,584,2449
E02002471,1727,690,549,638,3604
E02002472,921,374,282,314,1891
E02002473,1023,420,313,344,2100
E02002474,920,328,211,275,1734
E02002475,951,481,327,427,2186
E02002476,884,260,197,228,1569
E02002477,947,344,232,288,1811
E02002478,846,269,194,208,1517
E02002479,1320,467,428,437,2652
E02002480,817,304,267,317,1705
E02002481,1002,303,225,364,1894
E02002482,917,294,228,286,1725
